State,District,Winner,Dem Votes,Rep Votes,Total Votes,Total Wasted,Dem Wasted,Rep Wasted,Eff Gap,Percentile,Adv Dem Wasted,Adv Rep Wasted,Adv Eff Gap,Adv Percentile
ALABAMA,1,REPUBLICAN,116949,211825,328774,164386,116949,47437,21.1428,39.5402,-1,-1,-1,-1
ALABAMA,2,REPUBLICAN,105286,197996,303282,151640,105286,46354,19.4314,36.092,-1,-1,-1,-1
ALABAMA,3,REPUBLICAN,104595,217384,321979,160989,104595,56394,14.9702,28.9655,-1,-1,-1,-1
ALABAMA,4,REPUBLICAN,56237,261553,317790,158894,56237,102657,14.6071,28.5057,-1,-1,-1,-1
ALABAMA,5,REPUBLICAN,0,253094,253094,126546,0,126546,49.9996,94.9425,-1,-1,-1,-1
ALABAMA,6,REPUBLICAN,0,274160,274160,137079,0,137079,49.9996,95.1724,-1,-1,-1,-1
ALABAMA,7,DEMOCRAT,225742,0,225742,112870,112870,0,49.9996,95.4023,-1,-1,-1,-1
ALASKA,0,REPUBLICAN,159856,192126,351982,175990,159856,16134,40.8322,76.092,-1,-1,-1,-1
ARIZONA,1,DEMOCRAT,188469,176709,365178,182588,5879,176709,46.7799,87.1264,-1,-1,-1,-1
ARIZONA,2,DEMOCRAT,209945,170975,380920,190459,19484,170975,39.7698,74.9425,-1,-1,-1,-1
ARIZONA,3,DEMOCRAT,174243,95594,269837,134918,39324,95594,20.8533,38.8506,-1,-1,-1,-1
ARIZONA,4,REPUBLICAN,120484,278002,398486,199242,120484,78758,10.4711,19.5402,-1,-1,-1,-1
ARIZONA,5,REPUBLICAN,183171,262414,445585,222792,183171,39621,32.2161,61.3793,-1,-1,-1,-1
ARIZONA,6,REPUBLICAN,199644,217783,417427,208713,199644,9069,45.6547,84.5977,-1,-1,-1,-1
ARIZONA,7,DEMOCRAT,165452,50226,215678,107838,57612,50226,3.4245,6.4368,-1,-1,-1,-1
ARIZONA,8,REPUBLICAN,170816,251633,422449,211224,170816,40408,30.8695,58.8506,-1,-1,-1,-1
ARIZONA,9,DEMOCRAT,217094,135180,352274,176136,40956,135180,26.7474,50.1149,-1,-1,-1,-1
ARKANSAS,1,REPUBLICAN,0,237596,237596,118797,0,118797,49.9996,95.6322,-1,-1,-1,-1
ARKANSAS,2,REPUBLICAN,148410,184093,332503,166251,148410,17841,39.2685,74.023,-1,-1,-1,-1
ARKANSAS,3,REPUBLICAN,106325,214960,321285,160642,106325,54317,16.1875,30.3448,-1,-1,-1,-1
ARKANSAS,4,REPUBLICAN,75750,191617,267367,133683,75750,57933,6.6639,11.954,-1,-1,-1,-1
CALIFORNIA,1,REPUBLICAN,154073,204190,358263,179131,154073,25058,36.0113,68.7356,-1,-1,-1,-1
CALIFORNIA,2,DEMOCRAT,294435,94320,388755,194377,100057,94320,1.4757,2.7586,-1,-1,-1,-1
CALIFORNIA,3,DEMOCRAT,176043,145945,321988,160993,15048,145945,40.6528,75.6322,-1,-1,-1,-1
CALIFORNIA,4,REPUBLICAN,194731,247291,442022,221010,194731,26279,38.1094,72.8736,-1,-1,-1,-1
CALIFORNIA,5,DEMOCRAT,271233,85227,356460,178229,93002,85227,2.1812,4.1379,-1,-1,-1,-1
CALIFORNIA,6,DEMOCRAT,229648,83466,313114,156556,73090,83466,3.3138,5.977,-1,-1,-1,-1
CALIFORNIA,7,DEMOCRAT,217416,166549,383965,191982,25433,166549,36.7523,69.6552,-1,-1,-1,-1
CALIFORNIA,8,REPUBLICAN,124400,158711,283111,141555,124400,17155,37.8809,72.1839,-1,-1,-1,-1
CALIFORNIA,9,DEMOCRAT,174252,128358,302610,151304,22946,128358,34.8343,66.6667,-1,-1,-1,-1
CALIFORNIA,10,DEMOCRAT,166865,135629,302494,151246,15617,135629,39.6742,74.7126,-1,-1,-1,-1
CALIFORNIA,11,DEMOCRAT,271063,100293,371356,185677,85384,100293,4.0147,7.3563,-1,-1,-1,-1
CALIFORNIA,12,DEMOCRAT,81174,0,81174,40586,40586,0,49.9988,93.1034,-1,-1,-1,-1
CALIFORNIA,13,DEMOCRAT,327863,34955,362818,181408,146453,34955,30.7311,58.1609,-1,-1,-1,-1
CALIFORNIA,14,DEMOCRAT,278300,72705,351005,175502,102797,72705,8.5731,16.5517,-1,-1,-1,-1
CALIFORNIA,15,DEMOCRAT,242991,99710,342701,171350,71640,99710,8.1908,15.4023,-1,-1,-1,-1
CALIFORNIA,16,DEMOCRAT,128690,88039,216729,108364,20325,88039,31.2436,59.5402,-1,-1,-1,-1
CALIFORNIA,17,DEMOCRAT,212137,85199,297336,148667,63468,85199,7.3086,13.1034,-1,-1,-1,-1
CALIFORNIA,18,DEMOCRAT,126751,0,126751,63375,63375,0,49.9996,95.8621,-1,-1,-1,-1
CALIFORNIA,19,DEMOCRAT,224385,88642,313027,156513,67871,88642,6.6355,11.7241,-1,-1,-1,-1
CALIFORNIA,20,DEMOCRAT,236896,71658,308554,154276,82618,71658,3.5521,6.6667,-1,-1,-1,-1
CALIFORNIA,21,REPUBLICAN,84406,85928,170334,85166,84406,760,49.107,92.4138,-1,-1,-1,-1
CALIFORNIA,22,REPUBLICAN,144251,170888,315139,157569,144251,13318,41.5477,76.7816,-1,-1,-1,-1
CALIFORNIA,23,REPUBLICAN,115896,190222,306118,153058,115896,37162,25.7201,47.8161,-1,-1,-1,-1
CALIFORNIA,24,DEMOCRAT,212564,149781,362345,181172,31391,149781,32.6733,62.5287,-1,-1,-1,-1
CALIFORNIA,25,REPUBLICAN,169305,169638,338943,169471,169305,166,49.9019,92.6437,-1,-1,-1,-1
CALIFORNIA,26,DEMOCRAT,208856,135877,344733,172366,36489,135877,28.8304,54.7126,-1,-1,-1,-1
CALIFORNIA,27,DEMOCRAT,221411,95907,317318,158658,62751,95907,10.4488,19.3103,-1,-1,-1,-1
CALIFORNIA,28,DEMOCRAT,244271,91928,336199,168099,76171,91928,4.6868,8.5057,-1,-1,-1,-1
CALIFORNIA,29,DEMOCRAT,119420,0,119420,59709,59709,0,49.9992,93.5632,-1,-1,-1,-1
CALIFORNIA,30,DEMOCRAT,240038,105426,345464,172731,67305,105426,11.0347,20.4598,-1,-1,-1,-1
CALIFORNIA,31,DEMOCRAT,175315,110735,286050,143024,32289,110735,27.4239,51.4943,-1,-1,-1,-1
CALIFORNIA,32,DEMOCRAT,172942,86818,259760,129879,43061,86818,16.8452,32.1839,-1,-1,-1,-1
CALIFORNIA,33,DEMOCRAT,257094,123334,380428,190213,66879,123334,14.8399,28.7356,-1,-1,-1,-1
CALIFORNIA,34,DEMOCRAT,108792,0,108792,54395,54395,0,49.9991,93.3333,-1,-1,-1,-1
CALIFORNIA,35,DEMOCRAT,169405,74941,244346,122172,47231,74941,11.3405,20.9195,-1,-1,-1,-1
CALIFORNIA,36,DEMOCRAT,185151,121698,306849,153424,31726,121698,29.3213,55.8621,-1,-1,-1,-1
CALIFORNIA,37,DEMOCRAT,254916,41705,296621,148310,106605,41705,21.8798,40.9195,-1,-1,-1,-1
CALIFORNIA,38,DEMOCRAT,65739,0,65739,32869,32869,0,49.9992,93.7931,-1,-1,-1,-1
CALIFORNIA,39,REPUBLICAN,169837,173946,343783,171891,169837,2054,48.8049,91.7241,-1,-1,-1,-1
CALIFORNIA,40,DEMOCRAT,135572,50809,186381,93190,42381,50809,4.5219,7.8161,-1,-1,-1,-1
CALIFORNIA,41,DEMOCRAT,168126,94447,262573,131286,36839,94447,21.9398,41.1494,-1,-1,-1,-1
CALIFORNIA,42,REPUBLICAN,157773,210274,368047,184023,157773,26250,35.7354,67.8161,-1,-1,-1,-1
CALIFORNIA,43,DEMOCRAT,199210,78688,277898,138948,60260,78688,6.6312,11.4943,-1,-1,-1,-1
CALIFORNIA,44,DEMOCRAT,139661,0,139661,69830,69830,0,49.9996,96.092,-1,-1,-1,-1
CALIFORNIA,45,DEMOCRAT,221843,193096,414939,207469,14373,193096,43.0721,79.5402,-1,-1,-1,-1
CALIFORNIA,46,DEMOCRAT,157803,71716,229519,114759,43043,71716,12.4926,24.1379,-1,-1,-1,-1
CALIFORNIA,47,DEMOCRAT,197028,114371,311399,155699,41328,114371,23.4564,43.6782,-1,-1,-1,-1
CALIFORNIA,48,REPUBLICAN,193362,201738,395100,197549,193362,4187,47.8803,89.8851,-1,-1,-1,-1
CALIFORNIA,49,DEMOCRAT,205349,181157,386506,193252,12095,181157,43.7411,81.1494,-1,-1,-1,-1
CALIFORNIA,50,REPUBLICAN,166869,195521,362390,181194,166869,14325,42.0939,77.2414,-1,-1,-1,-1
CALIFORNIA,51,DEMOCRAT,165596,76841,242437,121218,44377,76841,13.3907,26.8966,-1,-1,-1,-1
CALIFORNIA,52,DEMOCRAT,244145,152350,396495,198247,45897,152350,26.8485,50.3448,-1,-1,-1,-1
CALIFORNIA,53,DEMOCRAT,199244,0,199244,99621,99621,0,49.9995,94.4828,-1,-1,-1,-1
COLORADO,1,DEMOCRAT,331621,105955,437576,218787,112832,105955,1.5716,3.2184,-1,-1,-1,-1
COLORADO,2,DEMOCRAT,316925,182547,499472,249735,67188,182547,23.0962,42.5287,-1,-1,-1,-1
COLORADO,3,REPUBLICAN,194122,220634,414756,207377,194122,13255,43.608,80.9195,-1,-1,-1,-1
COLORADO,4,REPUBLICAN,173945,285606,459551,229775,173945,55830,25.7023,47.5862,-1,-1,-1,-1
COLORADO,5,REPUBLICAN,161600,249013,410613,205306,161600,43706,28.7117,54.2529,-1,-1,-1,-1
COLORADO,6,DEMOCRAT,250314,175192,425506,212752,37560,175192,32.3455,61.8391,-1,-1,-1,-1
COLORADO,7,DEMOCRAT,250525,159301,409826,204912,45611,159301,27.741,52.4138,-1,-1,-1,-1
CONNECTICUT,1,DEMOCRAT,213001,122111,335112,167555,45444,122111,22.878,42.069,-1,-1,-1,-1
CONNECTICUT,2,DEMOCRAT,207303,140356,347659,173829,33473,140356,30.7436,58.3908,-1,-1,-1,-1
CONNECTICUT,3,DEMOCRAT,194259,131568,325827,162913,31345,131568,30.7596,58.6207,-1,-1,-1,-1
CONNECTICUT,4,DEMOCRAT,224432,130627,355059,177529,46902,130627,23.5806,44.1379,-1,-1,-1,-1
CONNECTICUT,5,DEMOCRAT,183797,151988,335785,167892,15904,151988,40.5271,75.1724,-1,-1,-1,-1
DELAWARE,0,DEMOCRAT,281382,196392,477774,238886,42494,196392,32.2115,61.1494,-1,-1,-1,-1
FLORIDA,1,REPUBLICAN,149172,283352,432524,216261,149172,67089,18.9777,35.4023,-1,-1,-1,-1
FLORIDA,2,REPUBLICAN,0,305337,305337,152668,0,152668,49.9998,98.1609,-1,-1,-1,-1
FLORIDA,3,REPUBLICAN,167326,223075,390401,195200,167326,27874,35.7202,67.5862,-1,-1,-1,-1
FLORIDA,4,REPUBLICAN,196423,308497,504920,252459,196423,56036,27.8038,52.6437,-1,-1,-1,-1
FLORIDA,5,DEMOCRAT,219463,117510,336973,168486,50976,117510,19.7446,36.3218,-1,-1,-1,-1
FLORIDA,6,REPUBLICAN,172305,265393,437698,218848,172305,46543,28.7326,54.4828,-1,-1,-1,-1
FLORIDA,7,DEMOCRAT,224946,175750,400696,200347,24597,175750,37.7226,71.954,-1,-1,-1,-1
FLORIDA,8,REPUBLICAN,177695,282093,459788,229893,177695,52198,27.2945,51.2644,-1,-1,-1,-1
FLORIDA,9,DEMOCRAT,240724,188889,429613,214806,25917,188889,37.9346,72.6437,-1,-1,-1,-1
FLORIDA,10,DEMOCRAT,239434,136889,376323,188161,51272,136889,22.7509,41.8391,-1,-1,-1,-1
FLORIDA,11,REPUBLICAN,158094,316979,475073,237536,158094,79442,16.5558,31.4943,-1,-1,-1,-1
FLORIDA,12,REPUBLICAN,168194,284941,453135,226567,168194,58373,24.2358,45.2874,-1,-1,-1,-1
FLORIDA,13,DEMOCRAT,215405,190713,406118,203058,12345,190713,43.9202,81.8391,-1,-1,-1,-1
FLORIDA,14,DEMOCRAT,224240,147896,372136,186067,38171,147896,29.4852,56.092,-1,-1,-1,-1
FLORIDA,15,REPUBLICAN,174297,216374,390671,195335,174297,21038,39.2297,73.7931,-1,-1,-1,-1
FLORIDA,16,REPUBLICAN,215683,269001,484684,242341,215683,26658,38.9996,73.5632,-1,-1,-1,-1
FLORIDA,17,REPUBLICAN,140487,266514,407001,203500,140487,63013,19.0353,35.6322,-1,-1,-1,-1
FLORIDA,18,REPUBLICAN,186674,253286,439960,219979,186674,33305,34.8598,67.1264,-1,-1,-1,-1
FLORIDA,19,REPUBLICAN,172146,272440,444586,222292,172146,50146,27.4413,51.7241,-1,-1,-1,-1
FLORIDA,20,DEMOCRAT,253661,68748,322409,161204,92456,68748,7.3534,13.7931,-1,-1,-1,-1
FLORIDA,21,DEMOCRAT,237925,157612,395537,197768,40156,157612,29.6953,56.3218,-1,-1,-1,-1
FLORIDA,22,DEMOCRAT,235764,166553,402317,201158,34605,166553,32.797,62.9885,-1,-1,-1,-1
FLORIDA,23,DEMOCRAT,221239,158874,380113,190056,31182,158874,33.5932,65.2874,-1,-1,-1,-1
FLORIDA,24,DEMOCRAT,218825,59084,277909,138954,79870,59084,7.4794,14.2529,-1,-1,-1,-1
FLORIDA,25,REPUBLICAN,0,100,100,49,0,49,49.0,92.1839,-1,-1,-1,-1
FLORIDA,26,REPUBLICAN,165407,177223,342630,171314,165407,5907,46.5517,86.6667,-1,-1,-1,-1
FLORIDA,27,REPUBLICAN,166758,176141,342899,171449,166758,4691,47.2638,88.5057,-1,-1,-1,-1
GEORGIA,1,REPUBLICAN,135238,189457,324695,162347,135238,27109,33.3017,64.1379,-1,-1,-1,-1
GEORGIA,2,DEMOCRAT,161397,111620,273017,136508,24888,111620,31.768,60.4598,-1,-1,-1,-1
GEORGIA,3,REPUBLICAN,129792,241526,371318,185658,129792,55866,19.9091,36.5517,-1,-1,-1,-1
GEORGIA,4,DEMOCRAT,278906,69393,348299,174149,104756,69393,10.1531,18.1609,-1,-1,-1,-1
GEORGIA,5,DEMOCRAT,301857,52646,354503,177251,124605,52646,20.2986,37.0115,-1,-1,-1,-1
GEORGIA,6,DEMOCRAT,216775,180329,397104,198551,18222,180329,40.8223,75.8621,-1,-1,-1,-1
GEORGIA,7,DEMOCRAT,190900,180564,371464,185731,5167,180564,47.2178,88.046,-1,-1,-1,-1
GEORGIA,8,REPUBLICAN,109264,198701,307965,153982,109264,44718,20.9589,39.0805,-1,-1,-1,-1
GEORGIA,9,REPUBLICAN,79797,292750,372547,186273,79797,106476,7.1612,12.6437,-1,-1,-1,-1
GEORGIA,10,REPUBLICAN,142636,235810,378446,189222,142636,46586,25.3801,46.8966,-1,-1,-1,-1
GEORGIA,11,REPUBLICAN,160623,245259,405882,202940,160623,42317,29.1479,55.1724,-1,-1,-1,-1
GEORGIA,12,REPUBLICAN,129061,181038,310099,155049,129061,25988,33.2387,63.4483,-1,-1,-1,-1
GEORGIA,13,DEMOCRAT,279045,81476,360521,180260,98784,81476,4.8008,8.9655,-1,-1,-1,-1
GEORGIA,14,REPUBLICAN,77798,229827,307625,153812,77798,76014,0.5799,0.9195,-1,-1,-1,-1
HAWAII,1,DEMOCRAT,183245,71188,254433,127216,56028,71188,5.9583,10.3448,-1,-1,-1,-1
HAWAII,2,DEMOCRAT,171517,84027,255544,127771,43744,84027,15.7636,29.6552,-1,-1,-1,-1
IDAHO,1,REPUBLICAN,131380,310736,442116,221057,131380,89677,9.4326,17.2414,-1,-1,-1,-1
IDAHO,2,REPUBLICAN,124151,250669,374820,187409,124151,63258,16.2459,30.5747,-1,-1,-1,-1
ILLINOIS,1,DEMOCRAT,239943,85027,324970,162484,77457,85027,2.3294,4.3678,-1,-1,-1,-1
ILLINOIS,2,DEMOCRAT,234896,63142,298038,149018,85876,63142,7.6279,14.7126,-1,-1,-1,-1
ILLINOIS,3,DEMOCRAT,172997,133851,306848,153423,19572,133851,37.2429,71.2644,-1,-1,-1,-1
ILLINOIS,4,DEMOCRAT,187219,35518,222737,111368,75850,35518,18.1075,33.7931,-1,-1,-1,-1
ILLINOIS,5,DEMOCRAT,255661,96200,351861,175930,79730,96200,4.6808,8.2759,-1,-1,-1,-1
ILLINOIS,6,DEMOCRAT,213777,183891,397668,198833,14942,183891,42.4849,78.1609,-1,-1,-1,-1
ILLINOIS,7,DEMOCRAT,249383,41390,290773,145386,103996,41390,21.5309,40.4598,-1,-1,-1,-1
ILLINOIS,8,DEMOCRAT,186251,0,186251,93125,93125,0,49.9997,97.0115,-1,-1,-1,-1
ILLINOIS,9,DEMOCRAT,262045,107125,369170,184584,77459,107125,8.0359,15.1724,-1,-1,-1,-1
ILLINOIS,10,DEMOCRAT,202402,114442,316844,158421,43979,114442,22.239,41.3793,-1,-1,-1,-1
ILLINOIS,11,DEMOCRAT,194557,112807,307364,153681,40874,112807,23.4032,43.4483,-1,-1,-1,-1
ILLINOIS,12,REPUBLICAN,127577,194839,322416,161207,127577,33630,29.1384,54.9425,-1,-1,-1,-1
ILLINOIS,13,REPUBLICAN,151648,181373,333021,166510,151648,14862,41.0743,76.5517,-1,-1,-1,-1
ILLINOIS,14,DEMOCRAT,203209,197835,401044,200521,2686,197835,48.6602,91.0345,-1,-1,-1,-1
ILLINOIS,15,REPUBLICAN,88559,244947,333506,166752,88559,78193,3.1082,5.5172,-1,-1,-1,-1
ILLINOIS,16,REPUBLICAN,119313,218839,338152,169075,119313,49762,20.568,37.7011,-1,-1,-1,-1
ILLINOIS,17,DEMOCRAT,156011,143863,299874,149936,6073,143863,45.9493,85.5172,-1,-1,-1,-1
ILLINOIS,18,REPUBLICAN,110039,261840,371879,185939,110039,75900,9.1801,17.0115,-1,-1,-1,-1
INDIANA,1,DEMOCRAT,185180,132247,317427,158713,26466,132247,33.3245,64.3678,-1,-1,-1,-1
INDIANA,2,REPUBLICAN,114967,183601,298568,149283,114967,34316,27.0126,50.5747,-1,-1,-1,-1
INDIANA,3,REPUBLICAN,104762,220989,325751,162875,104762,58113,14.3204,28.2759,-1,-1,-1,-1
INDIANA,4,REPUBLICAN,112984,225531,338515,169257,112984,56273,16.7529,31.954,-1,-1,-1,-1
INDIANA,5,REPUBLICAN,191226,208212,399438,199718,191226,8492,45.7478,84.8276,-1,-1,-1,-1
INDIANA,6,REPUBLICAN,91103,225319,316422,158210,91103,67107,7.5835,14.4828,-1,-1,-1,-1
INDIANA,7,DEMOCRAT,176422,106146,282568,141283,35137,106146,25.1299,46.6667,-1,-1,-1,-1
INDIANA,8,REPUBLICAN,95691,214643,310334,155166,95691,59475,11.67,21.8391,-1,-1,-1,-1
INDIANA,9,REPUBLICAN,122566,222057,344623,172311,122566,49745,21.1306,39.3103,-1,-1,-1,-1
IOWA,1,REPUBLICAN,201347,212088,413435,206717,201347,5370,47.4021,88.9655,-1,-1,-1,-1
IOWA,2,REPUBLICAN,196958,196964,393922,196960,196958,2,49.9987,92.8736,-1,-1,-1,-1
IOWA,3,DEMOCRAT,219205,212997,432202,216100,3103,212997,48.5639,90.5747,-1,-1,-1,-1
IOWA,4,REPUBLICAN,144761,237369,382130,191064,144761,46303,25.7656,48.046,-1,-1,-1,-1
KANSAS,1,REPUBLICAN,84393,208229,292622,146310,84393,61917,7.6809,14.9425,-1,-1,-1,-1
KANSAS,2,REPUBLICAN,136650,185464,322114,161056,136650,24406,34.846,66.8966,-1,-1,-1,-1
KANSAS,3,DEMOCRAT,220049,178773,398822,199410,20637,178773,39.6508,74.4828,-1,-1,-1,-1
KANSAS,4,REPUBLICAN,116166,203432,319598,159798,116166,43632,22.6954,41.6092,-1,-1,-1,-1
KENTUCKY,1,REPUBLICAN,82141,246329,328470,164234,82141,82093,0.0146,0.0,-1,-1,-1,-1
KENTUCKY,2,REPUBLICAN,94643,255735,350378,175188,94643,80545,4.0237,7.5862,-1,-1,-1,-1
KENTUCKY,3,DEMOCRAT,230672,137425,368097,184048,46623,137425,24.668,45.7471,-1,-1,-1,-1
KENTUCKY,4,REPUBLICAN,125896,256613,382509,191254,125896,65358,15.8266,29.8851,-1,-1,-1,-1
KENTUCKY,5,REPUBLICAN,47056,250914,297970,148984,47056,101928,18.4153,34.4828,-1,-1,-1,-1
KENTUCKY,6,REPUBLICAN,155011,216948,371959,185979,155011,30968,33.3486,64.5977,-1,-1,-1,-1
LOUISIANA,1,REPUBLICAN,94730,270330,365060,182529,94730,87799,1.8986,3.4483,-1,-1,-1,-1
LOUISIANA,2,DEMOCRAT,33684,15565,49249,24624,9059,15565,13.2104,26.2069,-1,-1,-1,-1
LOUISIANA,3,REPUBLICAN,60852,230480,291332,145665,60852,84813,8.2246,15.8621,-1,-1,-1,-1
LOUISIANA,4,REPUBLICAN,23813,185265,209078,104538,23813,80725,27.2205,51.0345,-1,-1,-1,-1
LOUISIANA,5,REPUBLICAN,50812,149183,199995,99997,50812,49185,0.8135,1.1494,-1,-1,-1,-1
LOUISIANA,6,REPUBLICAN,95541,265706,361247,180623,95541,85082,2.8952,4.8276,-1,-1,-1,-1
MAINE,1,DEMOCRAT,271004,165008,436012,218005,52997,165008,25.6899,47.3563,-1,-1,-1,-1
MAINE,2,DEMOCRAT,197974,175228,373202,186600,11372,175228,43.9054,81.6092,-1,-1,-1,-1
MARYLAND,1,REPUBLICAN,143877,250901,394778,197388,143877,53511,22.8903,42.2989,-1,-1,-1,-1
MARYLAND,2,DEMOCRAT,224836,106355,331191,165595,59240,106355,14.2259,28.046,-1,-1,-1,-1
MARYLAND,3,DEMOCRAT,260358,112117,372475,186237,74120,112117,10.2012,18.3908,-1,-1,-1,-1
MARYLAND,4,DEMOCRAT,282119,71671,353790,176894,105223,71671,9.4836,17.4713,-1,-1,-1,-1
MARYLAND,5,DEMOCRAT,274210,123525,397735,198867,75342,123525,12.1143,22.5287,-1,-1,-1,-1
MARYLAND,6,DEMOCRAT,215540,143599,359139,179569,35970,143599,29.9686,57.7011,-1,-1,-1,-1
MARYLAND,7,DEMOCRAT,237084,92825,329909,164954,72129,92825,6.2732,11.0345,-1,-1,-1,-1
MARYLAND,8,DEMOCRAT,274716,127157,401873,200936,73779,127157,13.2823,26.6667,-1,-1,-1,-1
MASSACHUSETTS,1,DEMOCRAT,275376,0,275376,137687,137687,0,49.9996,96.3218,-1,-1,-1,-1
MASSACHUSETTS,2,DEMOCRAT,249854,132220,382074,191036,58816,132220,19.212,35.8621,-1,-1,-1,-1
MASSACHUSETTS,3,DEMOCRAT,286896,0,286896,143447,143447,0,49.9997,97.2414,-1,-1,-1,-1
MASSACHUSETTS,4,DEMOCRAT,251102,160474,411576,205787,45313,160474,27.9805,53.3333,-1,-1,-1,-1
MASSACHUSETTS,5,DEMOCRAT,294427,101351,395778,197888,96537,101351,1.2163,2.069,-1,-1,-1,-1
MASSACHUSETTS,6,DEMOCRAT,286377,150695,437072,218535,67840,150695,18.9568,35.1724,-1,-1,-1,-1
MASSACHUSETTS,7,DEMOCRAT,267362,0,267362,133680,133680,0,49.9996,96.5517,-1,-1,-1,-1
MASSACHUSETTS,8,DEMOCRAT,310940,0,310940,155469,155469,0,49.9997,97.4713,-1,-1,-1,-1
MASSACHUSETTS,9,DEMOCRAT,260262,154261,414523,207261,53000,154261,24.4283,45.5172,-1,-1,-1,-1
MICHIGAN,1,REPUBLICAN,153328,256581,409909,204954,153328,51626,24.8109,45.977,-1,-1,-1,-1
MICHIGAN,2,REPUBLICAN,154122,238711,392833,196416,154122,42294,28.4671,53.7931,-1,-1,-1,-1
MICHIGAN,3,REPUBLICAN,189769,213649,403418,201708,189769,11939,44.0808,82.069,-1,-1,-1,-1
MICHIGAN,4,REPUBLICAN,120802,242621,363423,181711,120802,60909,16.4802,31.2644,-1,-1,-1,-1
MICHIGAN,5,DEMOCRAT,196599,150772,347371,173685,22913,150772,36.8076,69.8851,-1,-1,-1,-1
MICHIGAN,6,REPUBLICAN,152085,211496,363581,181790,152085,29705,33.6596,65.7471,-1,-1,-1,-1
MICHIGAN,7,REPUBLICAN,159743,227524,387267,193633,159743,33890,32.4977,62.069,-1,-1,-1,-1
MICHIGAN,8,DEMOCRAT,217922,202525,420447,210223,7698,202525,46.3381,85.977,-1,-1,-1,-1
MICHIGAN,9,DEMOCRAT,230318,153296,383614,191806,38510,153296,29.9223,57.4713,-1,-1,-1,-1
MICHIGAN,10,REPUBLICAN,138179,271607,409786,204892,138179,66713,17.4398,32.8736,-1,-1,-1,-1
MICHIGAN,11,DEMOCRAT,226128,215405,441533,220766,5361,215405,47.5715,89.1954,-1,-1,-1,-1
MICHIGAN,12,DEMOCRAT,254957,117719,372676,186337,68618,117719,13.1753,25.977,-1,-1,-1,-1
MICHIGAN,13,DEMOCRAT,223205,53311,276516,138257,84946,53311,11.4406,21.1494,-1,-1,-1,-1
MICHIGAN,14,DEMOCRAT,271370,62664,334034,167016,104352,62664,12.4802,23.908,-1,-1,-1,-1
MINNESOTA,1,REPUBLICAN,0,179234,179234,89616,0,89616,49.9994,94.023,-1,-1,-1,-1
MINNESOTA,2,DEMOCRAT,204534,194954,399488,199743,4789,194954,47.6022,89.4253,-1,-1,-1,-1
MINNESOTA,3,DEMOCRAT,246666,196625,443291,221645,25020,196625,38.7116,73.1034,-1,-1,-1,-1
MINNESOTA,4,DEMOCRAT,245813,112730,358543,179271,66541,112730,12.8824,25.0575,-1,-1,-1,-1
MINNESOTA,5,DEMOCRAT,255924,102878,358802,179400,76522,102878,7.3456,13.5632,-1,-1,-1,-1
MINNESOTA,6,REPUBLICAN,0,270901,270901,135450,0,135450,49.9998,98.3908,-1,-1,-1,-1
MINNESOTA,7,REPUBLICAN,144840,194066,338906,169452,144840,24612,35.4753,67.3563,-1,-1,-1,-1
MINNESOTA,8,REPUBLICAN,0,223432,223432,111715,0,111715,49.9996,96.7816,-1,-1,-1,-1
MISSISSIPPI,1,REPUBLICAN,104008,228787,332795,166397,104008,62389,12.5059,24.3678,-1,-1,-1,-1
MISSISSIPPI,2,DEMOCRAT,196224,101010,297234,148616,47606,101010,17.967,33.5632,-1,-1,-1,-1
MISSISSIPPI,3,REPUBLICAN,120782,221064,341846,170922,120782,50140,20.6649,38.6207,-1,-1,-1,-1
MISSISSIPPI,4,REPUBLICAN,0,255971,255971,127985,0,127985,49.9998,98.6207,-1,-1,-1,-1
MISSOURI,1,DEMOCRAT,249087,59940,309027,154513,94573,59940,11.2071,20.6897,-1,-1,-1,-1
MISSOURI,2,REPUBLICAN,204540,233157,437697,218848,204540,14308,43.462,80.6897,-1,-1,-1,-1
MISSOURI,3,REPUBLICAN,116095,282866,398961,199480,116095,83385,8.1988,15.6322,-1,-1,-1,-1
MISSOURI,4,REPUBLICAN,107635,245247,352882,176440,107635,68805,11.0037,20.2299,-1,-1,-1,-1
MISSOURI,5,DEMOCRAT,207180,135934,343114,171556,35622,135934,29.2358,55.4023,-1,-1,-1,-1
MISSOURI,6,REPUBLICAN,118926,258709,377635,188817,118926,69891,12.9848,25.5172,-1,-1,-1,-1
MISSOURI,7,REPUBLICAN,98111,254318,352429,176214,98111,78103,5.6772,10.1149,-1,-1,-1,-1
MISSOURI,8,REPUBLICAN,70561,253811,324372,162185,70561,91624,6.4935,11.2644,-1,-1,-1,-1
MONTANA,0,REPUBLICAN,262340,339169,601509,300754,262340,38414,37.2274,71.0345,-1,-1,-1,-1
NEBRASKA,1,REPUBLICAN,119622,189006,308628,154313,119622,34691,27.5189,51.954,-1,-1,-1,-1
NEBRASKA,2,REPUBLICAN,155706,171071,326777,163388,155706,7682,45.2982,84.1379,-1,-1,-1,-1
NEBRASKA,3,REPUBLICAN,50690,225157,275847,137923,50690,87233,13.2476,26.4368,-1,-1,-1,-1
NEVADA,1,DEMOCRAT,137868,74490,212358,106178,31688,74490,20.1556,36.7816,-1,-1,-1,-1
NEVADA,2,REPUBLICAN,155780,216078,371858,185928,155780,30148,33.7849,65.977,-1,-1,-1,-1
NEVADA,3,DEMOCRAT,203421,190975,394396,197197,6222,190975,46.8445,87.5862,-1,-1,-1,-1
NEVADA,4,DEMOCRAT,168457,152284,320741,160370,8086,152284,44.9578,83.908,-1,-1,-1,-1
NEW HAMPSHIRE,1,DEMOCRAT,205606,185159,390765,195382,10223,185159,44.7676,83.4483,-1,-1,-1,-1
NEW HAMPSHIRE,2,DEMOCRAT,208289,168886,377175,188587,19701,168886,39.5533,74.2529,-1,-1,-1,-1
NEW JERSEY,1,DEMOCRAT,240567,144463,385030,192514,48051,144463,25.0401,46.4368,-1,-1,-1,-1
NEW JERSEY,2,REPUBLICAN,173849,195526,369375,184687,173849,10838,44.1316,82.5287,-1,-1,-1,-1
NEW JERSEY,3,DEMOCRAT,229840,196327,426167,213083,16756,196327,42.1363,77.4713,-1,-1,-1,-1
NEW JERSEY,4,REPUBLICAN,162420,254103,416523,208261,162420,45841,27.9886,53.5632,-1,-1,-1,-1
NEW JERSEY,5,DEMOCRAT,225175,193333,418508,209253,15920,193333,42.3918,77.931,-1,-1,-1,-1
NEW JERSEY,6,DEMOCRAT,199648,126760,326408,163203,36443,126760,27.67,52.1839,-1,-1,-1,-1
NEW JERSEY,7,DEMOCRAT,219629,214318,433947,216973,2655,214318,48.7762,91.4943,-1,-1,-1,-1
NEW JERSEY,8,DEMOCRAT,176758,58686,235444,117721,59035,58686,0.1482,0.2299,-1,-1,-1,-1
NEW JERSEY,9,DEMOCRAT,203674,98629,302303,151151,52522,98629,15.2519,29.1954,-1,-1,-1,-1
NEW JERSEY,10,DEMOCRAT,241522,40298,281820,140909,100611,40298,21.4012,40.2299,-1,-1,-1,-1
NEW JERSEY,11,DEMOCRAT,235163,206013,441176,220587,14574,206013,43.3929,80.2299,-1,-1,-1,-1
NEW JERSEY,12,DEMOCRAT,230883,114591,345474,172736,58145,114591,16.3387,30.8046,-1,-1,-1,-1
NEW MEXICO,1,DEMOCRAT,186953,134337,321290,160644,26307,134337,33.6238,65.5172,-1,-1,-1,-1
NEW MEXICO,2,REPUBLICAN,122546,142283,264829,132414,122546,9868,42.5475,78.3908,-1,-1,-1,-1
NEW MEXICO,3,DEMOCRAT,186282,131166,317448,158723,27557,131166,32.6381,62.2989,-1,-1,-1,-1
NEW YORK,1,REPUBLICAN,160978,180855,341833,170916,160978,9938,44.1853,82.7586,-1,-1,-1,-1
NEW YORK,2,REPUBLICAN,144849,158151,303000,151499,144849,6650,45.6102,84.3678,-1,-1,-1,-1
NEW YORK,3,DEMOCRAT,196056,147461,343517,171758,24297,147461,35.8538,68.2759,-1,-1,-1,-1
NEW YORK,4,DEMOCRAT,199762,139559,339321,169660,30101,139559,32.258,61.6092,-1,-1,-1,-1
NEW YORK,5,DEMOCRAT,229125,0,229125,114562,114562,0,49.9998,98.8506,-1,-1,-1,-1
NEW YORK,6,DEMOCRAT,144149,67735,211884,105941,38206,67735,13.9364,27.5862,-1,-1,-1,-1
NEW YORK,7,DEMOCRAT,156889,29404,186293,93146,63742,29404,18.4323,34.7126,-1,-1,-1,-1
NEW YORK,8,DEMOCRAT,207111,39124,246235,123117,83993,39124,18.222,34.023,-1,-1,-1,-1
NEW YORK,9,DEMOCRAT,195758,40110,235868,117933,77823,40110,15.989,30.1149,-1,-1,-1,-1
NEW YORK,10,DEMOCRAT,181215,61045,242260,121129,60084,61045,0.3967,0.4598,-1,-1,-1,-1
NEW YORK,11,REPUBLICAN,134625,143420,278045,139022,134625,4397,46.837,87.3563,-1,-1,-1,-1
NEW YORK,12,DEMOCRAT,265172,49157,314329,157164,108007,49157,18.7224,34.9425,-1,-1,-1,-1
NEW YORK,13,DEMOCRAT,202916,19829,222745,111372,91543,19829,32.1956,60.9195,-1,-1,-1,-1
NEW YORK,14,DEMOCRAT,152661,52477,205138,102568,50091,52477,1.1631,1.6092,-1,-1,-1,-1
NEW YORK,15,DEMOCRAT,169533,18984,188517,94258,75274,18984,29.8594,57.2414,-1,-1,-1,-1
NEW YORK,16,DEMOCRAT,218514,0,218514,109256,109256,0,49.9995,94.7126,-1,-1,-1,-1
NEW YORK,17,DEMOCRAT,183976,117309,301285,150642,33333,117309,27.8726,53.1034,-1,-1,-1,-1
NEW YORK,18,DEMOCRAT,171161,128611,299772,149885,21274,128611,35.8062,68.046,-1,-1,-1,-1
NEW YORK,19,DEMOCRAT,168281,151475,319756,159877,8402,151475,44.7444,83.2184,-1,-1,-1,-1
NEW YORK,20,DEMOCRAT,194071,120839,314910,157454,36615,120839,26.7454,49.8851,-1,-1,-1,-1
NEW YORK,21,REPUBLICAN,122422,169684,292106,146052,122422,23630,33.8206,66.2069,-1,-1,-1,-1
NEW YORK,22,REPUBLICAN,138898,143291,282189,141094,138898,2196,48.4434,90.3448,-1,-1,-1,-1
NEW YORK,23,REPUBLICAN,116025,161800,277825,138912,116025,22887,33.524,64.8276,-1,-1,-1,-1
NEW YORK,24,REPUBLICAN,147877,156236,304113,152056,147877,4179,47.2515,88.2759,-1,-1,-1,-1
NEW YORK,25,DEMOCRAT,187503,115940,303443,151721,35781,115940,26.4165,48.9655,-1,-1,-1,-1
NEW YORK,26,DEMOCRAT,202400,91706,294106,147052,55346,91706,12.3629,23.4483,-1,-1,-1,-1
NEW YORK,27,REPUBLICAN,136686,192619,329305,164652,136686,27966,33.015,63.2184,-1,-1,-1,-1
NORTH CAROLINA,1,DEMOCRAT,188870,159748,348618,174308,14560,159748,41.6467,77.0115,-1,-1,-1,-1
NORTH CAROLINA,2,DEMOCRAT,311887,172544,484431,242215,69671,172544,21.2358,39.7701,-1,-1,-1,-1
NORTH CAROLINA,3,REPUBLICAN,132752,229800,362552,181275,132752,48523,23.2323,42.9885,-1,-1,-1,-1
NORTH CAROLINA,4,DEMOCRAT,332421,161298,493719,246859,85561,161298,15.3401,29.4253,-1,-1,-1,-1
NORTH CAROLINA,5,REPUBLICAN,119846,257843,377689,188844,119846,68998,13.4629,27.1264,-1,-1,-1,-1
NORTH CAROLINA,6,DEMOCRAT,253531,153598,407129,203564,49966,153598,25.4543,47.1264,-1,-1,-1,-1
NORTH CAROLINA,7,REPUBLICAN,179045,272443,451488,225743,179045,46698,29.3135,55.6322,-1,-1,-1,-1
NORTH CAROLINA,8,REPUBLICAN,177781,202774,380555,190277,177781,12496,43.4326,80.4598,-1,-1,-1,-1
NORTH CAROLINA,9,REPUBLICAN,179463,224661,404124,202061,179463,22598,38.8161,73.3333,-1,-1,-1,-1
NORTH CAROLINA,10,REPUBLICAN,128189,284095,412284,206141,128189,77952,12.185,22.7586,-1,-1,-1,-1
NORTH CAROLINA,11,REPUBLICAN,190609,245351,435960,217979,190609,27370,37.4436,71.4943,-1,-1,-1,-1
NORTH CAROLINA,12,DEMOCRAT,341457,0,341457,170728,170728,0,49.9999,99.7701,-1,-1,-1,-1
NORTH CAROLINA,13,REPUBLICAN,124684,267181,391865,195932,124684,71248,13.6363,27.3563,-1,-1,-1,-1
NORTH DAKOTA,0,REPUBLICAN,0,245229,245229,122614,0,122614,49.9998,99.0805,-1,-1,-1,-1
OHIO,1,REPUBLICAN,172022,199560,371582,185790,172022,13768,42.5893,78.6207,-1,-1,-1,-1
OHIO,2,REPUBLICAN,146781,230430,377211,188605,146781,41824,27.8245,52.8736,-1,-1,-1,-1
OHIO,3,DEMOCRAT,227420,93569,320989,160494,66925,93569,8.3006,16.092,-1,-1,-1,-1
OHIO,4,REPUBLICAN,101897,235875,337772,168885,101897,66988,10.3351,18.8506,-1,-1,-1,-1
OHIO,5,REPUBLICAN,120962,257019,377981,188990,120962,68028,14.0044,27.8161,-1,-1,-1,-1
OHIO,6,REPUBLICAN,85661,249130,334791,167395,85661,81734,1.173,1.8391,-1,-1,-1,-1
OHIO,7,REPUBLICAN,102271,236607,338878,169438,102271,67167,10.3589,19.0805,-1,-1,-1,-1
OHIO,8,REPUBLICAN,110766,246277,357043,178521,110766,67755,12.0464,22.069,-1,-1,-1,-1
OHIO,9,DEMOCRAT,190328,111385,301713,150856,39471,111385,23.8352,44.8276,-1,-1,-1,-1
OHIO,10,REPUBLICAN,151976,212972,364948,182473,151976,30497,33.2867,63.908,-1,-1,-1,-1
OHIO,11,DEMOCRAT,242098,60323,302421,151210,90887,60323,10.1064,17.931,-1,-1,-1,-1
OHIO,12,REPUBLICAN,182847,241790,424637,212318,182847,29471,36.1193,69.1954,-1,-1,-1,-1
OHIO,13,DEMOCRAT,173631,148648,322279,161139,12491,148648,42.2482,77.7011,-1,-1,-1,-1
OHIO,14,REPUBLICAN,158586,238864,397450,198724,158586,40138,29.802,57.0115,-1,-1,-1,-1
OHIO,15,REPUBLICAN,140183,243103,383286,191642,140183,51459,23.1482,42.7586,-1,-1,-1,-1
OHIO,16,REPUBLICAN,144071,247335,391406,195702,144071,51631,23.6174,44.3678,-1,-1,-1,-1
OKLAHOMA,1,REPUBLICAN,109641,213700,323341,161670,109641,52029,17.8177,33.3333,-1,-1,-1,-1
OKLAHOMA,2,REPUBLICAN,63472,216511,279983,139991,63472,76519,4.6599,8.046,-1,-1,-1,-1
OKLAHOMA,3,REPUBLICAN,66501,242677,309178,154588,66501,88087,6.9817,12.4138,-1,-1,-1,-1
OKLAHOMA,4,REPUBLICAN,90459,213096,303555,151777,90459,61318,9.5999,17.7011,-1,-1,-1,-1
OKLAHOMA,5,REPUBLICAN,145658,158191,303849,151924,145658,6266,45.8754,85.0575,-1,-1,-1,-1
OREGON,1,DEMOCRAT,297071,161928,458999,229499,67571,161928,20.5571,37.2414,-1,-1,-1,-1
OREGON,2,REPUBLICAN,168881,273835,442716,221357,168881,52476,26.2934,48.5057,-1,-1,-1,-1
OREGON,3,DEMOCRAT,343574,110570,454144,227071,116501,110570,1.306,2.2989,-1,-1,-1,-1
OREGON,4,DEMOCRAT,240950,216081,457031,228515,12434,216081,44.5587,82.9885,-1,-1,-1,-1
OREGON,5,DEMOCRAT,234863,204372,439235,219617,15245,204372,43.0583,79.3103,-1,-1,-1,-1
PENNSYLVANIA,1,REPUBLICAN,191875,249804,441679,220839,191875,28964,36.8845,70.3448,-1,-1,-1,-1
PENNSYLVANIA,2,DEMOCRAT,198140,75022,273162,136580,61558,75022,4.9289,9.4253,-1,-1,-1,-1
PENNSYLVANIA,3,DEMOCRAT,341708,33671,375379,187689,154018,33671,32.0601,60.6897,-1,-1,-1,-1
PENNSYLVANIA,4,DEMOCRAT,264637,179926,444563,222281,42355,179926,30.9452,59.0805,-1,-1,-1,-1
PENNSYLVANIA,5,DEMOCRAT,255743,139552,395295,197647,58095,139552,20.6066,37.931,-1,-1,-1,-1
PENNSYLVANIA,6,DEMOCRAT,226440,177526,403966,201982,24456,177526,37.8918,72.4138,-1,-1,-1,-1
PENNSYLVANIA,7,DEMOCRAT,195475,181407,376882,188440,7033,181407,46.2675,85.7471,-1,-1,-1,-1
PENNSYLVANIA,8,DEMOCRAT,178004,165783,343787,171893,6110,165783,46.4453,86.4368,-1,-1,-1,-1
PENNSYLVANIA,9,REPUBLICAN,118266,232988,351254,175626,118266,57360,17.3396,32.4138,-1,-1,-1,-1
PENNSYLVANIA,10,REPUBLICAN,182938,208896,391834,195916,182938,12978,43.3755,80.0,-1,-1,-1,-1
PENNSYLVANIA,11,REPUBLICAN,141325,241915,383240,191619,141325,50294,23.753,44.5977,-1,-1,-1,-1
PENNSYLVANIA,12,REPUBLICAN,99199,241035,340234,170116,99199,70917,8.3125,16.3218,-1,-1,-1,-1
PENNSYLVANIA,13,REPUBLICAN,96612,267789,364401,182200,96612,85588,3.0252,5.0575,-1,-1,-1,-1
PENNSYLVANIA,14,REPUBLICAN,131895,241688,373583,186791,131895,54896,20.6109,38.1609,-1,-1,-1,-1
PENNSYLVANIA,15,REPUBLICAN,92156,255058,347214,173606,92156,81450,3.0834,5.2874,-1,-1,-1,-1
PENNSYLVANIA,16,REPUBLICAN,143962,210088,354050,177024,143962,33062,31.3233,60.0,-1,-1,-1,-1
PENNSYLVANIA,17,DEMOCRAT,222253,212284,434537,217268,4984,212284,47.7059,89.6552,-1,-1,-1,-1
PENNSYLVANIA,18,DEMOCRAT,266084,118163,384247,192123,73960,118163,11.5038,21.3793,-1,-1,-1,-1
RHODE ISLAND,1,DEMOCRAT,158550,0,158550,79274,79274,0,49.9994,94.2529,-1,-1,-1,-1
RHODE ISLAND,2,DEMOCRAT,154086,109894,263980,131989,22095,109894,33.2597,63.6782,-1,-1,-1,-1
SOUTH CAROLINA,1,REPUBLICAN,210627,216042,426669,213334,210627,2707,48.731,91.2644,-1,-1,-1,-1
SOUTH CAROLINA,2,REPUBLICAN,155118,202715,357833,178916,155118,23798,36.6987,69.4253,-1,-1,-1,-1
SOUTH CAROLINA,3,REPUBLICAN,95712,237544,333256,166627,95712,70915,7.4408,14.023,-1,-1,-1,-1
SOUTH CAROLINA,4,REPUBLICAN,133023,222126,355149,177574,133023,44551,24.9112,46.2069,-1,-1,-1,-1
SOUTH CAROLINA,5,REPUBLICAN,145979,220006,365985,182992,145979,37013,29.7734,56.7816,-1,-1,-1,-1
SOUTH CAROLINA,6,DEMOCRAT,197477,89258,286735,143367,54109,89258,12.2584,22.9885,-1,-1,-1,-1
SOUTH CAROLINA,7,REPUBLICAN,138863,224993,363856,181927,138863,43064,26.3288,48.7356,-1,-1,-1,-1
SOUTH DAKOTA,0,REPUBLICAN,0,321984,321984,160991,0,160991,49.9997,97.7011,-1,-1,-1,-1
TENNESSEE,1,REPUBLICAN,68617,228181,296798,148398,68617,79781,3.7615,6.8966,-1,-1,-1,-1
TENNESSEE,2,REPUBLICAN,109684,238907,348591,174295,109684,64611,12.9301,25.2874,-1,-1,-1,-1
TENNESSEE,3,REPUBLICAN,97687,215571,313258,156628,97687,58941,12.3687,23.6782,-1,-1,-1,-1
TENNESSEE,4,REPUBLICAN,111908,223802,335710,167854,111908,55946,16.6697,31.7241,-1,-1,-1,-1
TENNESSEE,5,DEMOCRAT,252155,0,252155,126077,126077,0,49.9998,99.3103,-1,-1,-1,-1
TENNESSEE,6,REPUBLICAN,83852,257572,341424,170711,83852,86859,0.8807,1.3793,-1,-1,-1,-1
TENNESSEE,7,REPUBLICAN,95839,245188,341027,170513,95839,74674,6.2063,10.8046,-1,-1,-1,-1
TENNESSEE,8,REPUBLICAN,97890,227216,325106,162552,97890,64662,10.2207,18.6207,-1,-1,-1,-1
TENNESSEE,9,DEMOCRAT,187905,48818,236723,118361,69543,48818,8.755,16.7816,-1,-1,-1,-1
TEXAS,1,REPUBLICAN,83016,219726,302742,151370,83016,68354,4.8431,9.1954,-1,-1,-1,-1
TEXAS,2,REPUBLICAN,148374,192828,341202,170600,148374,22226,36.9716,70.5747,-1,-1,-1,-1
TEXAS,3,REPUBLICAN,179458,230512,409970,204984,179458,25526,37.5471,71.7241,-1,-1,-1,-1
TEXAS,4,REPUBLICAN,76326,253837,330163,165081,76326,88755,3.7645,7.1264,-1,-1,-1,-1
TEXAS,5,REPUBLICAN,100743,173836,274579,137289,100743,36546,23.3802,43.2184,-1,-1,-1,-1
TEXAS,6,REPUBLICAN,149530,179507,329037,164518,149530,14988,40.8896,76.3218,-1,-1,-1,-1
TEXAS,7,DEMOCRAT,159529,149054,308583,154291,5237,149054,46.6056,86.8966,-1,-1,-1,-1
TEXAS,8,REPUBLICAN,97409,277327,374736,187367,97409,89958,1.9883,3.908,-1,-1,-1,-1
TEXAS,9,DEMOCRAT,172938,49575,222513,111256,61681,49575,5.4406,9.6552,-1,-1,-1,-1
TEXAS,10,REPUBLICAN,187686,217216,404902,202450,187686,14764,42.7071,78.8506,-1,-1,-1,-1
TEXAS,11,REPUBLICAN,53394,232568,285962,142980,53394,89586,12.6562,24.5977,-1,-1,-1,-1
TEXAS,12,REPUBLICAN,121250,233853,355103,177551,121250,56301,18.2902,34.2529,-1,-1,-1,-1
TEXAS,13,REPUBLICAN,50477,217124,267601,133800,50477,83323,12.2742,23.2184,-1,-1,-1,-1
TEXAS,14,REPUBLICAN,118574,190541,309115,154557,118574,35983,26.7185,49.6552,-1,-1,-1,-1
TEXAS,15,DEMOCRAT,115605,109017,224622,112310,3293,109017,47.0675,87.8161,-1,-1,-1,-1
TEXAS,16,DEMOCRAT,154108,84006,238114,119056,35050,84006,20.5599,37.4713,-1,-1,-1,-1
TEXAS,17,REPUBLICAN,125565,171390,296955,148477,125565,22912,34.5685,66.4368,-1,-1,-1,-1
TEXAS,18,DEMOCRAT,180952,58033,238985,119492,61459,58033,1.4336,2.5287,-1,-1,-1,-1
TEXAS,19,REPUBLICAN,60583,198198,258781,129390,60583,68807,3.178,5.7471,-1,-1,-1,-1
TEXAS,20,DEMOCRAT,175078,89628,264706,132352,42724,89628,17.7193,33.1034,-1,-1,-1,-1
TEXAS,21,REPUBLICAN,205780,235740,441520,220759,205780,14979,43.2146,79.7701,-1,-1,-1,-1
TEXAS,22,REPUBLICAN,181998,210259,392257,196128,181998,14130,42.7954,79.0805,-1,-1,-1,-1
TEXAS,23,REPUBLICAN,137693,149395,287088,143543,137693,5850,45.9242,85.2874,-1,-1,-1,-1
TEXAS,24,REPUBLICAN,163326,167910,331236,165617,163326,2291,48.6164,90.8046,-1,-1,-1,-1
TEXAS,25,REPUBLICAN,165697,220088,385785,192892,165697,27195,35.9013,68.5057,-1,-1,-1,-1
TEXAS,26,REPUBLICAN,161009,261963,422972,211485,161009,50476,26.1325,48.2759,-1,-1,-1,-1
TEXAS,27,REPUBLICAN,95466,172305,267771,133885,95466,38419,21.3044,40.0,-1,-1,-1,-1
TEXAS,28,DEMOCRAT,137494,91925,229419,114709,22784,91925,30.1374,57.931,-1,-1,-1,-1
TEXAS,29,DEMOCRAT,111305,42840,154145,77072,34232,42840,5.5844,9.8851,-1,-1,-1,-1
TEXAS,30,DEMOCRAT,204928,48685,253613,126806,78121,48685,11.6067,21.6092,-1,-1,-1,-1
TEXAS,31,REPUBLICAN,176293,212695,388988,194493,176293,18200,40.6421,75.4023,-1,-1,-1,-1
TEXAS,32,DEMOCRAT,178542,157867,336409,168204,10337,157867,43.8544,81.3793,-1,-1,-1,-1
TEXAS,33,DEMOCRAT,105317,39638,144955,72477,32839,39638,4.6904,8.7356,-1,-1,-1,-1
TEXAS,34,DEMOCRAT,111439,84119,195558,97778,13659,84119,36.0302,68.9655,-1,-1,-1,-1
TEXAS,35,DEMOCRAT,176373,80795,257168,128583,47788,80795,12.8348,24.8276,-1,-1,-1,-1
TEXAS,36,REPUBLICAN,73418,222712,296130,148064,73418,74646,0.4147,0.6897,-1,-1,-1,-1
UTAH,1,REPUBLICAN,104194,237988,342182,171090,104194,66896,10.9,20.0,-1,-1,-1,-1
UTAH,2,REPUBLICAN,129762,208997,338759,169379,129762,39617,26.6104,49.4253,-1,-1,-1,-1
UTAH,3,REPUBLICAN,96067,246674,342741,171370,96067,75303,6.0582,10.5747,-1,-1,-1,-1
UTAH,4,REPUBLICAN,175923,179688,355611,177805,175923,1882,48.9414,91.954,-1,-1,-1,-1
VERMONT,0,DEMOCRAT,238827,95830,334657,167328,71498,95830,7.2707,12.8736,-1,-1,-1,-1
VIRGINIA,1,REPUBLICAN,186923,260614,447537,223768,186923,36845,33.5342,65.0575,-1,-1,-1,-1
VIRGINIA,2,DEMOCRAT,185733,165031,350764,175381,10350,165031,44.0983,82.2989,-1,-1,-1,-1
VIRGINIA,3,DEMOCRAT,233326,107299,340625,170312,63013,107299,13.0014,25.7471,-1,-1,-1,-1
VIRGINIA,4,DEMOCRAT,241142,149625,390767,195383,45758,149625,26.5803,49.1954,-1,-1,-1,-1
VIRGINIA,5,REPUBLICAN,190315,210988,401303,200651,190315,10336,44.8487,83.6782,-1,-1,-1,-1
VIRGINIA,6,REPUBLICAN,134729,246606,381335,190667,134729,55938,20.6619,38.3908,-1,-1,-1,-1
VIRGINIA,7,DEMOCRAT,230893,222623,453516,226757,4134,222623,48.1767,90.1149,-1,-1,-1,-1
VIRGINIA,8,DEMOCRAT,301454,95365,396819,198409,103044,95365,1.9351,3.6782,-1,-1,-1,-1
VIRGINIA,9,REPUBLICAN,0,271851,271851,135925,0,135925,49.9998,99.5402,-1,-1,-1,-1
VIRGINIA,10,DEMOCRAT,268734,206253,474987,237493,31240,206253,36.8459,70.1149,-1,-1,-1,-1
VIRGINIA,11,DEMOCRAT,280725,111380,392105,196052,84672,111380,6.8114,12.1839,-1,-1,-1,-1
WASHINGTON,1,DEMOCRAT,249944,176407,426351,213175,36768,176407,32.7521,62.7586,-1,-1,-1,-1
WASHINGTON,2,DEMOCRAT,255252,148384,403636,201817,53433,148384,23.5239,43.908,-1,-1,-1,-1
WASHINGTON,3,REPUBLICAN,181347,235579,416926,208462,181347,27115,36.9927,70.8046,-1,-1,-1,-1
WASHINGTON,4,REPUBLICAN,102667,202108,304775,152387,102667,49720,17.3725,32.6437,-1,-1,-1,-1
WASHINGTON,5,REPUBLICAN,155737,247815,403552,201775,155737,46038,27.1834,50.8046,-1,-1,-1,-1
WASHINGTON,6,DEMOCRAT,247429,168783,416212,208105,39322,168783,31.1046,59.3103,-1,-1,-1,-1
WASHINGTON,7,DEMOCRAT,387109,78240,465349,232674,154434,78240,16.3735,31.0345,-1,-1,-1,-1
WASHINGTON,8,DEMOCRAT,213123,198423,411546,205772,7349,198423,46.4283,86.2069,-1,-1,-1,-1
WASHINGTON,9,DEMOCRAT,258771,89697,348468,174233,84536,89697,1.4811,2.9885,-1,-1,-1,-1
WASHINGTON,10,DEMOCRAT,167937,0,167937,83968,83968,0,49.9997,97.931,-1,-1,-1,-1
WEST VIRGINIA,1,REPUBLICAN,81177,180488,261665,130832,81177,49655,12.0467,22.2989,-1,-1,-1,-1
WEST VIRGINIA,2,REPUBLICAN,100799,172195,272994,136496,100799,35697,23.8474,45.0575,-1,-1,-1,-1
WEST VIRGINIA,3,REPUBLICAN,64927,161585,226512,113255,64927,48328,7.3281,13.3333,-1,-1,-1,-1
WISCONSIN,1,REPUBLICAN,163170,238271,401441,200720,163170,37550,31.2923,59.7701,-1,-1,-1,-1
WISCONSIN,2,DEMOCRAT,318523,138306,456829,228414,90108,138306,10.5506,19.7701,-1,-1,-1,-1
WISCONSIN,3,DEMOCRAT,199870,189524,389394,194696,5172,189524,47.3433,88.7356,-1,-1,-1,-1
WISCONSIN,4,DEMOCRAT,232668,70769,303437,151718,80949,70769,3.3549,6.2069,-1,-1,-1,-1
WISCONSIN,5,REPUBLICAN,175902,265434,441336,220667,175902,44765,29.7136,56.5517,-1,-1,-1,-1
WISCONSIN,6,REPUBLICAN,164239,238874,403113,201556,164239,37317,31.4855,60.2299,-1,-1,-1,-1
WISCONSIN,7,REPUBLICAN,162741,252048,414789,207394,162741,44653,28.4694,54.023,-1,-1,-1,-1
WISCONSIN,8,REPUBLICAN,149558,268173,417731,208865,149558,59307,21.6051,40.6897,-1,-1,-1,-1
WYOMING,0,REPUBLICAN,66576,185732,252308,126153,66576,59577,2.774,4.5977,-1,-1,-1,-1
