State,District,Winner,Dem Votes,Rep Votes,Total Votes,Total Wasted,Dem Wasted,Rep Wasted,Eff Gap,Percentile,Adv Dem Wasted,Adv Rep Wasted,Adv Eff Gap,Adv Percentile
ALABAMA,1,REPUBLICAN,116949,211825,328774,164386,116949,47437,21.1428,39.5402,58474,8506,15.1983,57.931
ALABAMA,2,REPUBLICAN,105286,197996,303282,151640,105286,46354,19.4314,36.092,89493,7965,26.8819,92.4138
ALABAMA,3,REPUBLICAN,104595,217384,321979,160989,104595,56394,14.9702,28.9655,88905,11647,23.9947,86.6667
ALABAMA,4,REPUBLICAN,56237,261553,317790,158894,56237,102657,14.6071,28.5057,22494,37472,4.7132,23.4483
ALABAMA,5,REPUBLICAN,0,253094,253094,126546,0,126546,49.9996,94.9425,0,71005,28.0548,96.092
ALABAMA,6,REPUBLICAN,0,274160,274160,137079,0,137079,49.9996,95.1724,0,76916,28.0552,99.7701
ALABAMA,7,DEMOCRAT,225742,0,225742,112870,112870,0,49.9996,95.4023,63332,0,28.055,97.4713
ALASKA,0,REPUBLICAN,159856,192126,351982,175990,159856,16134,40.8322,76.092,7992,1792,1.7615,1.6092
ARIZONA,1,DEMOCRAT,188469,176709,365178,182588,5879,176709,46.7799,87.1264,653,8835,2.2406,13.5632
ARIZONA,2,DEMOCRAT,209945,170975,380920,190459,19484,170975,39.7698,74.9425,1155,34195,8.6737,44.3678
ARIZONA,3,DEMOCRAT,174243,95594,269837,134918,39324,95594,20.8533,38.8506,7111,47797,15.078,57.0115
ARIZONA,4,REPUBLICAN,120484,278002,398486,199242,120484,78758,10.4711,19.5402,102411,18399,21.0828,79.0805
ARIZONA,5,REPUBLICAN,183171,262414,445585,222792,183171,39621,32.2161,61.3793,36634,5091,7.079,30.5747
ARIZONA,6,REPUBLICAN,199644,217783,417427,208713,199644,9069,45.6547,84.5977,9982,1007,2.1501,10.8046
ARIZONA,7,DEMOCRAT,165452,50226,215678,107838,57612,50226,3.4245,6.4368,17439,27624,4.7223,23.6782
ARIZONA,8,REPUBLICAN,170816,251633,422449,211224,170816,40408,30.8695,58.8506,34163,5459,6.7947,27.8161
ARIZONA,9,DEMOCRAT,217094,135180,352274,176136,40956,135180,26.7474,50.1149,5823,67590,17.5338,70.3448
ARKANSAS,1,REPUBLICAN,0,237596,237596,118797,0,118797,49.9996,95.6322,0,66657,28.0548,96.3218
ARKANSAS,2,REPUBLICAN,148410,184093,332503,166251,148410,17841,39.2685,74.023,29682,1193,8.568,43.4483
ARKANSAS,3,REPUBLICAN,106325,214960,321285,160642,106325,54317,16.1875,30.3448,90376,10753,24.7827,87.8161
ARKANSAS,4,REPUBLICAN,75750,191617,267367,133683,75750,57933,6.6639,11.954,53024,14360,14.461,53.3333
CALIFORNIA,1,REPUBLICAN,154073,204190,358263,179131,154073,25058,36.0113,68.7356,30814,2582,7.8802,38.1609
CALIFORNIA,2,DEMOCRAT,294435,94320,388755,194377,100057,94320,1.4757,2.7586,28908,51876,5.9081,25.5172
CALIFORNIA,3,DEMOCRAT,176043,145945,321988,160993,15048,145945,40.6528,75.6322,1672,7297,1.747,1.1494
CALIFORNIA,4,REPUBLICAN,194731,247291,442022,221010,194731,26279,38.1094,72.8736,38946,2156,8.3231,42.2989
CALIFORNIA,5,DEMOCRAT,271233,85227,356460,178229,93002,85227,2.1812,4.1379,27345,46874,5.4786,24.3678
CALIFORNIA,6,DEMOCRAT,229648,83466,313114,156556,73090,83466,3.3138,5.977,19731,58426,12.3581,49.1954
CALIFORNIA,7,DEMOCRAT,217416,166549,383965,191982,25433,166549,36.7523,69.6552,2451,33309,8.0367,39.0805
CALIFORNIA,8,REPUBLICAN,124400,158711,283111,141555,124400,17155,37.8809,72.1839,24880,1452,8.2752,41.6092
CALIFORNIA,9,DEMOCRAT,174252,128358,302610,151304,22946,128358,34.8343,66.6667,2577,25671,7.6316,36.092
CALIFORNIA,10,DEMOCRAT,166865,135629,302494,151246,15617,135629,39.6742,74.7126,949,27125,8.6534,44.1379
CALIFORNIA,11,DEMOCRAT,271063,100293,371356,185677,85384,100293,4.0147,7.3563,22678,70205,12.7982,49.4253
CALIFORNIA,12,DEMOCRAT,81174,0,81174,40586,40586,0,49.9988,93.1034,22772,0,28.0533,93.1034
CALIFORNIA,13,DEMOCRAT,327863,34955,362818,181408,146453,34955,30.7311,58.1609,65826,5243,16.6979,65.7471
CALIFORNIA,14,DEMOCRAT,278300,72705,351005,175502,102797,72705,8.5731,16.5517,34405,39987,1.5903,0.4598
CALIFORNIA,15,DEMOCRAT,242991,99710,342701,171350,71640,99710,8.1908,15.4023,16952,69797,15.4201,59.0805
CALIFORNIA,16,DEMOCRAT,128690,88039,216729,108364,20325,88039,31.2436,59.5402,2710,17607,6.8736,28.7356
CALIFORNIA,17,DEMOCRAT,212137,85199,297336,148667,63468,85199,7.3086,13.1034,15437,59639,14.866,54.2529
CALIFORNIA,18,DEMOCRAT,126751,0,126751,63375,63375,0,49.9996,95.8621,35559,0,28.0542,93.7931
CALIFORNIA,19,DEMOCRAT,224385,88642,313027,156513,67871,88642,6.6355,11.7241,16837,62049,14.4435,53.1034
CALIFORNIA,20,DEMOCRAT,236896,71658,308554,154276,82618,71658,3.5521,6.6667,25080,39411,4.6446,23.2184
CALIFORNIA,21,REPUBLICAN,84406,85928,170334,85166,84406,760,49.107,92.4138,4220,84,2.4282,19.0805
CALIFORNIA,22,REPUBLICAN,144251,170888,315139,157569,144251,13318,41.5477,76.7816,7212,1479,1.8192,2.5287
CALIFORNIA,23,REPUBLICAN,115896,190222,306118,153058,115896,37162,25.7201,47.8161,57948,5584,17.1058,67.8161
CALIFORNIA,24,DEMOCRAT,212564,149781,362345,181172,31391,149781,32.6733,62.5287,3956,29956,7.1755,31.954
CALIFORNIA,25,REPUBLICAN,169305,169638,338943,169471,169305,166,49.9019,92.6437,8465,18,2.4922,19.5402
CALIFORNIA,26,DEMOCRAT,208856,135877,344733,172366,36489,135877,28.8304,54.7126,4502,67938,18.4015,74.9425
CALIFORNIA,27,DEMOCRAT,221411,95907,317318,158658,62751,95907,10.4488,19.3103,14667,81520,21.0681,78.8506
CALIFORNIA,28,DEMOCRAT,244271,91928,336199,168099,76171,91928,4.6868,8.5057,19903,64349,13.2201,50.3448
CALIFORNIA,29,DEMOCRAT,119420,0,119420,59709,59709,0,49.9992,93.5632,33502,0,28.0539,93.5632
CALIFORNIA,30,DEMOCRAT,240038,105426,345464,172731,67305,105426,11.0347,20.4598,15519,89612,21.4474,80.0
CALIFORNIA,31,DEMOCRAT,175315,110735,286050,143024,32289,110735,27.4239,51.4943,4406,55367,17.8154,71.7241
CALIFORNIA,32,DEMOCRAT,172942,86818,259760,129879,43061,86818,16.8452,32.1839,8314,73795,25.2083,89.4253
CALIFORNIA,33,DEMOCRAT,257094,123334,380428,190213,66879,123334,14.8399,28.7356,13872,104833,23.9102,86.4368
CALIFORNIA,34,DEMOCRAT,108792,0,108792,54395,54395,0,49.9991,93.3333,30521,0,28.0545,94.7126
CALIFORNIA,35,DEMOCRAT,169405,74941,244346,122172,47231,74941,11.3405,20.9195,10810,63699,21.6451,80.2299
CALIFORNIA,36,DEMOCRAT,185151,121698,306849,153424,31726,121698,29.3213,55.8621,3756,60849,18.6062,76.092
CALIFORNIA,37,DEMOCRAT,254916,41705,296621,148310,106605,41705,21.8798,40.9195,42850,10426,10.9311,46.2069
CALIFORNIA,38,DEMOCRAT,65739,0,65739,32869,32869,0,49.9992,93.7931,18442,0,28.0534,93.3333
CALIFORNIA,39,REPUBLICAN,169837,173946,343783,171891,169837,2054,48.8049,91.7241,8491,228,2.4036,18.6207
CALIFORNIA,40,DEMOCRAT,135572,50809,186381,93190,42381,50809,4.5219,7.8161,11119,35566,13.1167,49.8851
CALIFORNIA,41,DEMOCRAT,168126,94447,262573,131286,36839,94447,21.9398,41.1494,6444,47223,15.5305,60.2299
CALIFORNIA,42,REPUBLICAN,157773,210274,368047,184023,157773,26250,35.7354,67.8161,31554,2766,7.8218,37.2414
CALIFORNIA,43,DEMOCRAT,199210,78688,277898,138948,60260,78688,6.6312,11.4943,14951,55081,14.4406,52.8736
CALIFORNIA,44,DEMOCRAT,139661,0,139661,69830,69830,0,49.9996,96.092,39181,0,28.0544,94.2529
CALIFORNIA,45,DEMOCRAT,221843,193096,414939,207469,14373,193096,43.0721,79.5402,1596,9654,1.942,5.2874
CALIFORNIA,46,DEMOCRAT,157803,71716,229519,114759,43043,71716,12.4926,24.1379,9566,60958,22.3912,82.5287
CALIFORNIA,47,DEMOCRAT,197028,114371,311399,155699,41328,114371,23.4564,43.6782,6855,57185,16.1625,62.9885
CALIFORNIA,48,REPUBLICAN,193362,201738,395100,197549,193362,4187,47.8803,89.8851,9668,465,2.3293,16.5517
CALIFORNIA,49,DEMOCRAT,205349,181157,386506,193252,12095,181157,43.7411,81.1494,1343,9057,1.9958,6.8966
CALIFORNIA,50,REPUBLICAN,166869,195521,362390,181194,166869,14325,42.0939,77.2414,8343,1591,1.8632,2.9885
CALIFORNIA,51,DEMOCRAT,165596,76841,242437,121218,44377,76841,13.3907,26.8966,9621,65314,22.9722,84.8276
CALIFORNIA,52,DEMOCRAT,244145,152350,396495,198247,45897,152350,26.8485,50.3448,6487,76175,17.576,70.8046
CALIFORNIA,53,DEMOCRAT,199244,0,199244,99621,99621,0,49.9995,94.4828,55897,0,28.0545,94.9425
COLORADO,1,DEMOCRAT,331621,105955,437576,218787,112832,105955,1.5716,3.2184,32679,58275,5.8495,25.2874
COLORADO,2,DEMOCRAT,316925,182547,499472,249735,67188,182547,23.0962,42.5287,11296,91273,16.0123,61.6092
COLORADO,3,REPUBLICAN,194122,220634,414756,207377,194122,13255,43.608,80.9195,9706,1472,1.9853,6.6667
COLORADO,4,REPUBLICAN,173945,285606,459551,229775,173945,55830,25.7023,47.5862,86972,8397,17.0982,67.5862
COLORADO,5,REPUBLICAN,161600,249013,410613,205306,161600,43706,28.7117,54.2529,80800,5443,18.3523,74.4828
COLORADO,6,DEMOCRAT,250314,175192,425506,212752,37560,175192,32.3455,61.8391,4800,35038,7.1064,31.0345
COLORADO,7,DEMOCRAT,250525,159301,409826,204912,45611,159301,27.741,52.4138,6096,79650,17.9476,72.6437
CONNECTICUT,1,DEMOCRAT,213001,122111,335112,167555,45444,122111,22.878,42.069,7701,61055,15.9212,61.1494
CONNECTICUT,2,DEMOCRAT,207303,140356,347659,173829,33473,140356,30.7436,58.3908,4541,28071,6.7681,27.1264
CONNECTICUT,3,DEMOCRAT,194259,131568,325827,162913,31345,131568,30.7596,58.6207,4250,26313,6.7714,27.3563
CONNECTICUT,4,DEMOCRAT,224432,130627,355059,177529,46902,130627,23.5806,44.1379,7743,65313,16.2142,63.6782
CONNECTICUT,5,DEMOCRAT,183797,151988,335785,167892,15904,151988,40.5271,75.1724,1767,7599,1.7368,0.6897
DELAWARE,0,DEMOCRAT,281382,196392,477774,238886,42494,196392,32.2115,61.1494,5461,39278,7.078,30.3448
FLORIDA,1,REPUBLICAN,149172,283352,432524,216261,149172,67089,18.9777,35.4023,126796,11795,26.5884,91.7241
FLORIDA,2,REPUBLICAN,0,305337,305337,152668,0,152668,49.9998,98.1609,0,85662,28.0549,96.7816
FLORIDA,3,REPUBLICAN,167326,223075,390401,195200,167326,27874,35.7202,67.5862,33465,2940,7.8189,37.0115
FLORIDA,4,REPUBLICAN,196423,308497,504920,252459,196423,56036,27.8038,52.6437,98211,7458,17.9737,72.8736
FLORIDA,5,DEMOCRAT,219463,117510,336973,168486,50976,117510,19.7446,36.3218,8615,99883,27.0847,92.6437
FLORIDA,6,REPUBLICAN,172305,265393,437698,218848,172305,46543,28.7326,54.4828,86152,5787,18.3608,74.7126
FLORIDA,7,DEMOCRAT,224946,175750,400696,200347,24597,175750,37.7226,71.954,2126,35150,8.2417,41.3793
FLORIDA,8,REPUBLICAN,177695,282093,459788,229893,177695,52198,27.2945,51.2644,88847,7181,17.7617,71.4943
FLORIDA,9,DEMOCRAT,240724,188889,429613,214806,25917,188889,37.9346,72.6437,2179,37777,8.2861,42.069
FLORIDA,10,DEMOCRAT,239434,136889,376323,188161,51272,136889,22.7509,41.8391,8727,68444,15.8685,60.9195
FLORIDA,11,REPUBLICAN,158094,316979,475073,237536,158094,79442,16.5558,31.4943,134379,15512,25.0208,88.7356
FLORIDA,12,REPUBLICAN,168194,284941,453135,226567,168194,58373,24.2358,45.2874,84097,9387,16.4874,65.0575
FLORIDA,13,DEMOCRAT,215405,190713,406118,203058,12345,190713,43.9202,81.8391,1371,9535,2.0103,7.5862
FLORIDA,14,DEMOCRAT,224240,147896,372136,186067,38171,147896,29.4852,56.092,4453,73948,18.6746,76.3218
FLORIDA,15,REPUBLICAN,174297,216374,390671,195335,174297,21038,39.2297,73.7931,34859,1419,8.5596,43.2184
FLORIDA,16,REPUBLICAN,215683,269001,484684,242341,215683,26658,38.9996,73.5632,43136,1884,8.5111,42.9885
FLORIDA,17,REPUBLICAN,140487,266514,407001,203500,140487,63013,19.0353,35.6322,119413,11047,26.6255,91.954
FLORIDA,18,REPUBLICAN,186674,253286,439960,219979,186674,33305,34.8598,67.1264,37334,3734,7.6371,36.5517
FLORIDA,19,REPUBLICAN,172146,272440,444586,222292,172146,50146,27.4413,51.7241,86073,6835,17.8229,71.954
FLORIDA,20,DEMOCRAT,253661,68748,322409,161204,92456,68748,7.3534,13.7931,30291,37811,2.3324,16.7816
FLORIDA,21,DEMOCRAT,237925,157612,395537,197768,40156,157612,29.6953,56.3218,4595,78806,18.7621,76.5517
FLORIDA,22,DEMOCRAT,235764,166553,402317,201158,34605,166553,32.797,62.9885,4337,33310,7.2015,32.4138
FLORIDA,23,DEMOCRAT,221239,158874,380113,190056,31182,158874,33.5932,65.2874,3761,31774,7.3697,34.7126
FLORIDA,24,DEMOCRAT,218825,59084,277909,138954,79870,59084,7.4794,14.2529,26227,32496,2.2558,14.2529
FLORIDA,25,REPUBLICAN,0,100,100,49,0,49,49.0,92.1839,0,26,26.0,91.0345
FLORIDA,26,REPUBLICAN,165407,177223,342630,171314,165407,5907,46.5517,86.6667,8270,656,2.2222,13.1034
FLORIDA,27,REPUBLICAN,166758,176141,342899,171449,166758,4691,47.2638,88.5057,8337,521,2.2794,15.1724
GEORGIA,1,REPUBLICAN,135238,189457,324695,162347,135238,27109,33.3017,64.1379,27047,3318,7.3081,33.5632
GEORGIA,2,DEMOCRAT,161397,111620,273017,136508,24888,111620,31.768,60.4598,3255,22324,6.9845,30.1149
GEORGIA,3,REPUBLICAN,129792,241526,371318,185658,129792,55866,19.9091,36.5517,110323,9357,27.1912,92.8736
GEORGIA,4,DEMOCRAT,278906,69393,348299,174149,104756,69393,10.1531,18.1609,35036,27757,2.0899,9.8851
GEORGIA,5,DEMOCRAT,301857,52646,354503,177251,124605,52646,20.2986,37.0115,48721,13161,10.0309,44.5977
GEORGIA,6,DEMOCRAT,216775,180329,397104,198551,18222,180329,40.8223,75.8621,2024,9016,1.7607,1.3793
GEORGIA,7,DEMOCRAT,190900,180564,371464,185731,5167,180564,47.2178,88.046,574,9028,2.2759,14.7126
GEORGIA,8,REPUBLICAN,109264,198701,307965,153982,109264,44718,20.9589,39.0805,54632,8062,15.1218,57.4713
GEORGIA,9,REPUBLICAN,79797,292750,372547,186273,79797,106476,7.1612,12.6437,43888,34763,2.4494,19.3103
GEORGIA,10,REPUBLICAN,142636,235810,378446,189222,142636,46586,25.3801,46.8966,71318,7118,16.9641,66.8966
GEORGIA,11,REPUBLICAN,160623,245259,405882,202940,160623,42317,29.1479,55.1724,80311,5086,18.5337,75.4023
GEORGIA,12,REPUBLICAN,129061,181038,310099,155049,129061,25988,33.2387,63.4483,25812,3190,7.2951,32.8736
GEORGIA,13,DEMOCRAT,279045,81476,360521,180260,98784,81476,4.8008,8.9655,30805,44811,3.8849,22.069
GEORGIA,14,REPUBLICAN,77798,229827,307625,153812,77798,76014,0.5799,0.9195,54458,21721,10.6419,45.2874
HAWAII,1,DEMOCRAT,183245,71188,254433,127216,56028,71188,5.9583,10.3448,14164,49831,14.0182,51.954
HAWAII,2,DEMOCRAT,171517,84027,255544,127771,43744,84027,15.7636,29.6552,8794,71422,24.5077,87.3563
IDAHO,1,REPUBLICAN,131380,310736,442116,221057,131380,89677,9.4326,17.2414,91966,20346,16.1994,63.4483
IDAHO,2,REPUBLICAN,124151,250669,374820,187409,124151,63258,16.2459,30.5747,105528,12497,24.8202,88.046
ILLINOIS,1,DEMOCRAT,239943,85027,324970,162484,77457,85027,2.3294,4.3678,21366,59518,11.7402,47.8161
ILLINOIS,2,DEMOCRAT,234896,63142,298038,149018,85876,63142,7.6279,14.7126,28274,34728,2.1655,11.2644
ILLINOIS,3,DEMOCRAT,172997,133851,306848,153423,19572,133851,37.2429,71.2644,1792,26770,8.1402,40.6897
ILLINOIS,4,DEMOCRAT,187219,35518,222737,111368,75850,35518,18.1075,33.7931,29295,14207,6.7739,27.5862
ILLINOIS,5,DEMOCRAT,255661,96200,351861,175930,79730,96200,4.6808,8.2759,20836,67339,13.2163,50.1149
ILLINOIS,6,DEMOCRAT,213777,183891,397668,198833,14942,183891,42.4849,78.1609,1660,9194,1.8945,3.908
ILLINOIS,7,DEMOCRAT,249383,41390,290773,145386,103996,41390,21.5309,40.4598,41555,10347,10.7328,45.7471
ILLINOIS,8,DEMOCRAT,186251,0,186251,93125,93125,0,49.9997,97.0115,52252,0,28.0546,95.1724
ILLINOIS,9,DEMOCRAT,262045,107125,369170,184584,77459,107125,8.0359,15.1724,18421,74987,15.3225,58.6207
ILLINOIS,10,DEMOCRAT,202402,114442,316844,158421,43979,114442,22.239,41.3793,7618,57221,15.6553,60.4598
ILLINOIS,11,DEMOCRAT,194557,112807,307364,153681,40874,112807,23.4032,43.4483,6794,56403,16.1401,62.7586
ILLINOIS,12,REPUBLICAN,127577,194839,322416,161207,127577,33630,29.1384,54.9425,63788,4045,18.5298,75.1724
ILLINOIS,13,REPUBLICAN,151648,181373,333021,166510,151648,14862,41.0743,76.5517,7582,1651,1.781,2.069
ILLINOIS,14,DEMOCRAT,203209,197835,401044,200521,2686,197835,48.6602,91.0345,298,9891,2.392,17.931
ILLINOIS,15,REPUBLICAN,88559,244947,333506,166752,88559,78193,3.1082,5.5172,61991,21206,12.2292,48.9655
ILLINOIS,16,REPUBLICAN,119313,218839,338152,169075,119313,49762,20.568,37.7011,59656,9072,14.959,55.6322
ILLINOIS,17,DEMOCRAT,156011,143863,299874,149936,6073,143863,45.9493,85.5172,674,7193,2.1739,11.954
ILLINOIS,18,REPUBLICAN,110039,261840,371879,185939,110039,75900,9.1801,17.0115,77027,17374,16.041,62.069
INDIANA,1,DEMOCRAT,185180,132247,317427,158713,26466,132247,33.3245,64.3678,3235,26449,7.3132,33.7931
INDIANA,2,REPUBLICAN,114967,183601,298568,149283,114967,34316,27.0126,50.5747,57483,4803,17.6442,71.0345
INDIANA,3,REPUBLICAN,104762,220989,325751,162875,104762,58113,14.3204,28.2759,89047,12254,23.5741,86.2069
INDIANA,4,REPUBLICAN,112984,225531,338515,169257,112984,56273,16.7529,31.954,96036,10905,25.1484,89.1954
INDIANA,5,REPUBLICAN,191226,208212,399438,199718,191226,8492,45.7478,84.8276,9561,943,2.1575,11.0345
INDIANA,6,REPUBLICAN,91103,225319,316422,158210,91103,67107,7.5835,14.4828,63772,16186,15.0388,56.7816
INDIANA,7,DEMOCRAT,176422,106146,282568,141283,35137,106146,25.1299,46.6667,5433,53073,16.8597,66.6667
INDIANA,8,REPUBLICAN,95691,214643,310334,155166,95691,59475,11.67,21.8391,81337,13502,21.8587,80.6897
INDIANA,9,REPUBLICAN,122566,222057,344623,172311,122566,49745,21.1306,39.3103,61283,8923,15.1934,57.7011
IOWA,1,REPUBLICAN,201347,212088,413435,206717,201347,5370,47.4021,88.9655,10067,596,2.2908,15.6322
IOWA,2,REPUBLICAN,196958,196964,393922,196960,196958,2,49.9987,92.8736,9847,0,2.4997,19.7701
IOWA,3,DEMOCRAT,219205,212997,432202,216100,3103,212997,48.5639,90.5747,344,10649,2.3843,17.4713
IOWA,4,REPUBLICAN,144761,237369,382130,191064,144761,46303,25.7656,48.046,72380,6942,17.1245,68.046
KANSAS,1,REPUBLICAN,84393,208229,292622,146310,84393,61917,7.6809,14.9425,59075,14890,15.0997,57.2414
KANSAS,2,REPUBLICAN,136650,185464,322114,161056,136650,24406,34.846,66.8966,27330,2739,7.6343,36.3218
KANSAS,3,DEMOCRAT,220049,178773,398822,199410,20637,178773,39.6508,74.4828,1262,35754,8.6485,43.908
KANSAS,4,REPUBLICAN,116166,203432,319598,159798,116166,43632,22.6954,41.6092,58083,7441,15.8455,60.6897
KENTUCKY,1,REPUBLICAN,82141,246329,328470,164234,82141,82093,0.0146,0.0,57498,23709,10.2868,44.8276
KENTUCKY,2,REPUBLICAN,94643,255735,350378,175188,94643,80545,4.0237,7.5862,66250,21388,12.8039,49.6552
KENTUCKY,3,DEMOCRAT,230672,137425,368097,184048,46623,137425,24.668,45.7471,7360,68712,16.6673,65.5172
KENTUCKY,4,REPUBLICAN,125896,256613,382509,191254,125896,65358,15.8266,29.8851,107011,13109,24.549,87.5862
KENTUCKY,5,REPUBLICAN,47056,250914,297970,148984,47056,101928,18.4153,34.4828,18822,39548,6.9557,29.6552
KENTUCKY,6,REPUBLICAN,155011,216948,371959,185979,155011,30968,33.3486,64.5977,31002,3782,7.318,34.023
LOUISIANA,1,REPUBLICAN,94730,270330,365060,182529,94730,87799,1.8986,3.4483,66310,24439,11.4696,47.3563
LOUISIANA,2,DEMOCRAT,33684,15565,49249,24624,9059,15565,13.2104,26.2069,1973,13230,22.8573,84.3678
LOUISIANA,3,REPUBLICAN,60852,230480,291332,145665,60852,84813,8.2246,15.8621,33468,28218,1.8021,2.2989
LOUISIANA,4,REPUBLICAN,23813,185265,209078,104538,23813,80725,27.2205,51.0345,5953,35166,13.9723,51.7241
LOUISIANA,5,REPUBLICAN,50812,149183,199995,99997,50812,49185,0.8135,1.1494,35568,13991,10.7888,45.977
LOUISIANA,6,REPUBLICAN,95541,265706,361247,180623,95541,85082,2.8952,4.8276,66878,23184,12.0953,48.2759
MAINE,1,DEMOCRAT,271004,165008,436012,218005,52997,165008,25.6899,47.3563,7976,82504,17.0931,67.3563
MAINE,2,DEMOCRAT,197974,175228,373202,186600,11372,175228,43.9054,81.6092,1263,8761,2.0091,7.3563
MARYLAND,1,REPUBLICAN,143877,250901,394778,197388,143877,53511,22.8903,42.2989,71938,9064,15.9264,61.3793
MARYLAND,2,DEMOCRAT,224836,106355,331191,165595,59240,106355,14.2259,28.046,12529,90401,23.5127,85.977
MARYLAND,3,DEMOCRAT,260358,112117,372475,186237,74120,112117,10.2012,18.3908,17422,95299,20.908,77.931
MARYLAND,4,DEMOCRAT,282119,71671,353790,176894,105223,71671,9.4836,17.4713,35752,39419,1.0365,0.0
MARYLAND,5,DEMOCRAT,274210,123525,397735,198867,75342,123525,12.1143,22.5287,16912,104996,22.1464,81.3793
MARYLAND,6,DEMOCRAT,215540,143599,359139,179569,35970,143599,29.9686,57.7011,4008,71799,18.876,77.7011
MARYLAND,7,DEMOCRAT,237084,92825,329909,164954,72129,92825,6.2732,11.0345,18077,64977,14.216,52.6437
MARYLAND,8,DEMOCRAT,274716,127157,401873,200936,73779,127157,13.2823,26.6667,16045,108083,22.9023,84.5977
MASSACHUSETTS,1,DEMOCRAT,275376,0,275376,137687,137687,0,49.9996,96.3218,77257,0,28.0551,98.6207
MASSACHUSETTS,2,DEMOCRAT,249854,132220,382074,191036,58816,132220,19.212,35.8621,10220,112387,26.7401,92.1839
MASSACHUSETTS,3,DEMOCRAT,286896,0,286896,143447,143447,0,49.9997,97.2414,80489,0,28.0551,98.8506
MASSACHUSETTS,4,DEMOCRAT,251102,160474,411576,205787,45313,160474,27.9805,53.3333,5958,80237,18.0475,73.5632
MASSACHUSETTS,5,DEMOCRAT,294427,101351,395778,197888,96537,101351,1.2163,2.069,27246,70945,11.0413,46.8966
MASSACHUSETTS,6,DEMOCRAT,286377,150695,437072,218535,67840,150695,18.9568,35.1724,11939,128090,26.5748,91.4943
MASSACHUSETTS,7,DEMOCRAT,267362,0,267362,133680,133680,0,49.9996,96.5517,75008,0,28.0548,96.5517
MASSACHUSETTS,8,DEMOCRAT,310940,0,310940,155469,155469,0,49.9997,97.4713,87234,0,28.0549,97.0115
MASSACHUSETTS,9,DEMOCRAT,260262,154261,414523,207261,53000,154261,24.4283,45.5172,8454,77130,16.5675,65.2874
MICHIGAN,1,REPUBLICAN,153328,256581,409909,204954,153328,51626,24.8109,45.977,76664,8099,16.7269,65.977
MICHIGAN,2,REPUBLICAN,154122,238711,392833,196416,154122,42294,28.4671,53.7931,77061,5368,18.2502,74.023
MICHIGAN,3,REPUBLICAN,189769,213649,403418,201708,189769,11939,44.0808,82.069,9488,1326,2.0232,7.8161
MICHIGAN,4,REPUBLICAN,120802,242621,363423,181711,120802,60909,16.4802,31.2644,102681,11927,24.972,88.5057
MICHIGAN,5,DEMOCRAT,196599,150772,347371,173685,22913,150772,36.8076,69.8851,2196,30154,8.0485,39.3103
MICHIGAN,6,REPUBLICAN,152085,211496,363581,181790,152085,29705,33.6596,65.7471,30417,3571,7.3838,35.1724
MICHIGAN,7,REPUBLICAN,159743,227524,387267,193633,159743,33890,32.4977,62.069,31948,4303,7.1385,31.4943
MICHIGAN,8,DEMOCRAT,217922,202525,420447,210223,7698,202525,46.3381,85.977,855,10126,2.205,12.4138
MICHIGAN,9,DEMOCRAT,230318,153296,383614,191806,38510,153296,29.9223,57.4713,4311,76648,18.8567,77.4713
MICHIGAN,10,REPUBLICAN,138179,271607,409786,204892,138179,66713,17.4398,32.8736,117452,12575,25.5931,90.1149
MICHIGAN,11,DEMOCRAT,226128,215405,441533,220766,5361,215405,47.5715,89.1954,595,10770,2.3045,15.8621
MICHIGAN,12,DEMOCRAT,254957,117719,372676,186337,68618,117719,13.1753,25.977,14968,100061,22.833,84.1379
MICHIGAN,13,DEMOCRAT,223205,53311,276516,138257,84946,53311,11.4406,21.1494,29200,21324,2.8483,20.4598
MICHIGAN,14,DEMOCRAT,271370,62664,334034,167016,104352,62664,12.4802,23.908,36624,25065,3.4604,21.3793
MINNESOTA,1,REPUBLICAN,0,179234,179234,89616,0,89616,49.9994,94.023,0,50283,28.0544,94.4828
MINNESOTA,2,DEMOCRAT,204534,194954,399488,199743,4789,194954,47.6022,89.4253,532,9747,2.3067,16.092
MINNESOTA,3,DEMOCRAT,246666,196625,443291,221645,25020,196625,38.7116,73.1034,1865,39325,8.4504,42.5287
MINNESOTA,4,DEMOCRAT,245813,112730,358543,179271,66541,112730,12.8824,25.0575,14634,95820,22.6433,83.2184
MINNESOTA,5,DEMOCRAT,255924,102878,358802,179400,76522,102878,7.3456,13.5632,18592,72014,14.889,54.7126
MINNESOTA,6,REPUBLICAN,0,270901,270901,135450,0,135450,49.9998,98.3908,0,76001,28.0549,97.2414
MINNESOTA,7,REPUBLICAN,144840,194066,338906,169452,144840,24612,35.4753,67.3563,28968,2645,7.7671,36.7816
MINNESOTA,8,REPUBLICAN,0,223432,223432,111715,0,111715,49.9996,96.7816,0,62683,28.0546,95.4023
MISSISSIPPI,1,REPUBLICAN,104008,228787,332795,166397,104008,62389,12.5059,24.3678,88406,13861,22.3997,82.7586
MISSISSIPPI,2,DEMOCRAT,196224,101010,297234,148616,47606,101010,17.967,33.5632,8773,85858,25.9341,90.8046
MISSISSIPPI,3,REPUBLICAN,120782,221064,341846,170922,120782,50140,20.6649,38.6207,60391,9116,14.9994,56.5517
MISSISSIPPI,4,REPUBLICAN,0,255971,255971,127985,0,127985,49.9998,98.6207,0,71812,28.0547,95.8621
MISSOURI,1,DEMOCRAT,249087,59940,309027,154513,94573,59940,11.2071,20.6897,32352,23976,2.7104,20.2299
MISSOURI,2,REPUBLICAN,204540,233157,437697,218848,204540,14308,43.462,80.6897,10227,1589,1.9735,6.4368
MISSOURI,3,REPUBLICAN,116095,282866,398961,199480,116095,83385,8.1988,15.6322,81266,19727,15.4248,59.3103
MISSOURI,4,REPUBLICAN,107635,245247,352882,176440,107635,68805,11.0037,20.2299,91489,15876,21.4273,79.7701
MISSOURI,5,DEMOCRAT,207180,135934,343114,171556,35622,135934,29.2358,55.4023,4249,67967,18.5705,75.6322
MISSOURI,6,REPUBLICAN,118926,258709,377635,188817,118926,69891,12.9848,25.5172,101087,15327,22.7098,83.6782
MISSOURI,7,REPUBLICAN,98111,254318,352429,176214,98111,78103,5.6772,10.1149,68677,19895,13.8417,51.4943
MISSOURI,8,REPUBLICAN,70561,253811,324372,162185,70561,91624,6.4935,11.2644,38808,29546,2.8554,20.6897
MONTANA,0,REPUBLICAN,262340,339169,601509,300754,262340,38414,37.2274,71.0345,52468,3523,8.137,40.4598
NEBRASKA,1,REPUBLICAN,119622,189006,308628,154313,119622,34691,27.5189,51.954,59811,4705,17.8552,72.1839
NEBRASKA,2,REPUBLICAN,155706,171071,326777,163388,155706,7682,45.2982,84.1379,7785,853,2.1213,10.3448
NEBRASKA,3,REPUBLICAN,50690,225157,275847,137923,50690,87233,13.2476,26.4368,20276,31067,3.912,22.2989
NEVADA,1,DEMOCRAT,137868,74490,212358,106178,31688,74490,20.1556,36.7816,5843,37245,14.7873,53.7931
NEVADA,2,REPUBLICAN,155780,216078,371858,185928,155780,30148,33.7849,65.977,31156,3600,7.4104,35.4023
NEVADA,3,DEMOCRAT,203421,190975,394396,197197,6222,190975,46.8445,87.5862,691,9548,2.2457,14.023
NEVADA,4,DEMOCRAT,168457,152284,320741,160370,8086,152284,44.9578,83.908,898,7614,2.0939,10.1149
NEW HAMPSHIRE,1,DEMOCRAT,205606,185159,390765,195382,10223,185159,44.7676,83.4483,1135,9257,2.0785,9.4253
NEW HAMPSHIRE,2,DEMOCRAT,208289,168886,377175,188587,19701,168886,39.5533,74.2529,1234,33777,8.6281,43.6782
NEW JERSEY,1,DEMOCRAT,240567,144463,385030,192514,48051,144463,25.0401,46.4368,7460,72231,16.8223,66.4368
NEW JERSEY,2,REPUBLICAN,173849,195526,369375,184687,173849,10838,44.1316,82.5287,8692,1204,2.0272,8.2759
NEW JERSEY,3,DEMOCRAT,229840,196327,426167,213083,16756,196327,42.1363,77.4713,1861,9816,1.8666,3.2184
NEW JERSEY,4,REPUBLICAN,162420,254103,416523,208261,162420,45841,27.9886,53.5632,81210,6024,18.0509,73.7931
NEW JERSEY,5,DEMOCRAT,225175,193333,418508,209253,15920,193333,42.3918,77.931,1768,9666,1.8872,3.6782
NEW JERSEY,6,DEMOCRAT,199648,126760,326408,163203,36443,126760,27.67,52.1839,4894,63380,17.9181,72.4138
NEW JERSEY,7,DEMOCRAT,219629,214318,433947,216973,2655,214318,48.7762,91.4943,294,10715,2.4014,18.3908
NEW JERSEY,8,DEMOCRAT,176758,58686,235444,117721,59035,58686,0.1482,0.2299,16466,32277,6.7154,26.8966
NEW JERSEY,9,DEMOCRAT,203674,98629,302303,151151,52522,98629,15.2519,29.1954,10746,83834,24.1771,86.8966
NEW JERSEY,10,DEMOCRAT,241522,40298,281820,140909,100611,40298,21.4012,40.2299,40113,10074,10.6589,45.5172
NEW JERSEY,11,DEMOCRAT,235163,206013,441176,220587,14574,206013,43.3929,80.2299,1619,10300,1.9677,5.977
NEW JERSEY,12,DEMOCRAT,230883,114591,345474,172736,58145,114591,16.3387,30.8046,11447,97402,24.8803,88.2759
NEW MEXICO,1,DEMOCRAT,186953,134337,321290,160644,26307,134337,33.6238,65.5172,3168,26867,7.3762,34.9425
NEW MEXICO,2,REPUBLICAN,122546,142283,264829,132414,122546,9868,42.5475,78.3908,6127,1096,1.8997,4.1379
NEW MEXICO,3,DEMOCRAT,186282,131166,317448,158723,27557,131166,32.6381,62.2989,3478,26233,7.1681,31.7241
NEW YORK,1,REPUBLICAN,160978,180855,341833,170916,160978,9938,44.1853,82.7586,8048,1104,2.0314,8.5057
NEW YORK,2,REPUBLICAN,144849,158151,303000,151499,144849,6650,45.6102,84.3678,7242,738,2.1465,10.5747
NEW YORK,3,DEMOCRAT,196056,147461,343517,171758,24297,147461,35.8538,68.2759,2536,29492,7.8471,37.7011
NEW YORK,4,DEMOCRAT,199762,139559,339321,169660,30101,139559,32.258,61.6092,3861,27911,7.0877,30.8046
NEW YORK,5,DEMOCRAT,229125,0,229125,114562,114562,0,49.9998,98.8506,64281,0,28.055,97.7011
NEW YORK,6,DEMOCRAT,144149,67735,211884,105941,38206,67735,13.9364,27.5862,8151,57574,23.3255,85.5172
NEW YORK,7,DEMOCRAT,156889,29404,186293,93146,63742,29404,18.4323,34.7126,24737,11761,6.9654,29.8851
NEW YORK,8,DEMOCRAT,207111,39124,246235,123117,83993,39124,18.222,34.023,32496,15649,6.8418,28.2759
NEW YORK,9,DEMOCRAT,195758,40110,235868,117933,77823,40110,15.989,30.1149,29079,16044,5.5264,24.5977
NEW YORK,10,DEMOCRAT,181215,61045,242260,121129,60084,61045,0.3967,0.4598,17229,42731,10.5267,45.0575
NEW YORK,11,REPUBLICAN,134625,143420,278045,139022,134625,4397,46.837,87.3563,6731,488,2.2453,13.7931
NEW YORK,12,DEMOCRAT,265172,49157,314329,157164,108007,49157,18.7224,34.9425,42094,19662,7.1365,31.2644
NEW YORK,13,DEMOCRAT,202916,19829,222745,111372,91543,19829,32.1956,60.9195,42043,2974,17.5398,70.5747
NEW YORK,14,DEMOCRAT,152661,52477,205138,102568,50091,52477,1.1631,1.6092,14152,36733,11.0077,46.4368
NEW YORK,15,DEMOCRAT,169533,18984,188517,94258,75274,18984,29.8594,57.2414,33919,4746,15.475,59.5402
NEW YORK,16,DEMOCRAT,218514,0,218514,109256,109256,0,49.9995,94.7126,61304,0,28.055,97.931
NEW YORK,17,DEMOCRAT,183976,117309,301285,150642,33333,117309,27.8726,53.1034,4415,58654,18.0026,73.3333
NEW YORK,18,DEMOCRAT,171161,128611,299772,149885,21274,128611,35.8062,68.046,2229,25722,7.837,37.4713
NEW YORK,19,DEMOCRAT,168281,151475,319756,159877,8402,151475,44.7444,83.2184,933,7573,2.0766,9.1954
NEW YORK,20,DEMOCRAT,194071,120839,314910,157454,36615,120839,26.7454,49.8851,5206,60419,17.5329,70.1149
NEW YORK,21,REPUBLICAN,122422,169684,292106,146052,122422,23630,33.8206,66.2069,24484,2816,7.4179,35.6322
NEW YORK,22,REPUBLICAN,138898,143291,282189,141094,138898,2196,48.4434,90.3448,6944,243,2.3746,17.2414
NEW YORK,23,REPUBLICAN,116025,161800,277825,138912,116025,22887,33.524,64.8276,23205,2770,7.3553,34.2529
NEW YORK,24,REPUBLICAN,147877,156236,304113,152056,147877,4179,47.2515,88.2759,7393,464,2.2784,14.9425
NEW YORK,25,DEMOCRAT,187503,115940,303443,151721,35781,115940,26.4165,48.9655,5183,57970,17.396,68.9655
NEW YORK,26,DEMOCRAT,202400,91706,294106,147052,55346,91706,12.3629,23.4483,12343,77950,22.3073,82.069
NEW YORK,27,REPUBLICAN,136686,192619,329305,164652,136686,27966,33.015,63.2184,27337,3470,7.2477,32.6437
NORTH CAROLINA,1,DEMOCRAT,188870,159748,348618,174308,14560,159748,41.6467,77.0115,1617,7987,1.8272,2.7586
NORTH CAROLINA,2,DEMOCRAT,311887,172544,484431,242215,69671,172544,21.2358,39.7701,12458,86272,15.2373,58.1609
NORTH CAROLINA,3,REPUBLICAN,132752,229800,362552,181275,132752,48523,23.2323,42.9885,66376,8117,16.0691,62.2989
NORTH CAROLINA,4,DEMOCRAT,332421,161298,493719,246859,85561,161298,15.3401,29.4253,17455,137103,24.234,87.1264
NORTH CAROLINA,5,REPUBLICAN,119846,257843,377689,188844,119846,68998,13.4629,27.1264,101869,14928,23.0192,85.0575
NORTH CAROLINA,6,DEMOCRAT,253531,153598,407129,203564,49966,153598,25.4543,47.1264,7607,76799,16.9951,67.1264
NORTH CAROLINA,7,REPUBLICAN,179045,272443,451488,225743,179045,46698,29.3135,55.6322,89522,5532,18.6029,75.8621
NORTH CAROLINA,8,REPUBLICAN,177781,202774,380555,190277,177781,12496,43.4326,80.4598,8889,1388,1.9711,6.2069
NORTH CAROLINA,9,REPUBLICAN,179463,224661,404124,202061,179463,22598,38.8161,73.3333,35892,1654,8.4722,42.7586
NORTH CAROLINA,10,REPUBLICAN,128189,284095,412284,206141,128189,77952,12.185,22.7586,108960,17466,22.192,81.6092
NORTH CAROLINA,11,REPUBLICAN,190609,245351,435960,217979,190609,27370,37.4436,71.4943,38121,2449,8.1824,40.9195
NORTH CAROLINA,12,DEMOCRAT,341457,0,341457,170728,170728,0,49.9999,99.7701,95796,0,28.0551,99.0805
NORTH CAROLINA,13,REPUBLICAN,124684,267181,391865,195932,124684,71248,13.6363,27.3563,105981,15337,23.1314,85.2874
NORTH DAKOTA,0,REPUBLICAN,0,245229,245229,122614,0,122614,49.9998,99.0805,0,68799,28.055,98.1609
OHIO,1,REPUBLICAN,172022,199560,371582,185790,172022,13768,42.5893,78.6207,8601,1529,1.9032,4.3678
OHIO,2,REPUBLICAN,146781,230430,377211,188605,146781,41824,27.8245,52.8736,73390,5558,17.9825,73.1034
OHIO,3,DEMOCRAT,227420,93569,320989,160494,66925,93569,8.3006,16.092,15781,65498,15.4887,59.7701
OHIO,4,REPUBLICAN,101897,235875,337772,168885,101897,66988,10.3351,18.8506,86612,15698,20.9946,78.3908
OHIO,5,REPUBLICAN,120962,257019,377981,188990,120962,68028,14.0044,27.8161,102817,14485,23.3694,85.7471
OHIO,6,REPUBLICAN,85661,249130,334791,167395,85661,81734,1.173,1.8391,59962,23088,11.014,46.6667
OHIO,7,REPUBLICAN,102271,236607,338878,169438,102271,67167,10.3589,19.0805,86930,15732,21.0099,78.6207
OHIO,8,REPUBLICAN,110766,246277,357043,178521,110766,67755,12.0464,22.069,94151,15236,22.1024,80.9195
OHIO,9,DEMOCRAT,190328,111385,301713,150856,39471,111385,23.8352,44.8276,6452,55692,16.3201,64.5977
OHIO,10,REPUBLICAN,151976,212972,364948,182473,151976,30497,33.2867,63.908,30395,3735,7.3052,33.3333
OHIO,11,DEMOCRAT,242098,60323,302421,151210,90887,60323,10.1064,17.931,30366,24129,2.0624,8.9655
OHIO,12,REPUBLICAN,182847,241790,424637,212318,182847,29471,36.1193,69.1954,36569,3010,7.903,38.6207
OHIO,13,DEMOCRAT,173631,148648,322279,161139,12491,148648,42.2482,77.7011,1387,7432,1.8757,3.4483
OHIO,14,REPUBLICAN,158586,238864,397450,198724,158586,40138,29.802,57.0115,79293,4547,18.8064,77.2414
OHIO,15,REPUBLICAN,140183,243103,383286,191642,140183,51459,23.1482,42.7586,70091,8635,16.034,61.8391
OHIO,16,REPUBLICAN,144071,247335,391406,195702,144071,51631,23.6174,44.3678,72035,8512,16.2294,63.908
OKLAHOMA,1,REPUBLICAN,109641,213700,323341,161670,109641,52029,17.8177,33.3333,93194,9651,25.8374,90.5747
OKLAHOMA,2,REPUBLICAN,63472,216511,279983,139991,63472,76519,4.6599,8.046,34909,23791,3.971,22.5287
OKLAHOMA,3,REPUBLICAN,66501,242677,309178,154588,66501,88087,6.9817,12.4138,36575,28665,2.5584,20.0
OKLAHOMA,4,REPUBLICAN,90459,213096,303555,151777,90459,61318,9.5999,17.7011,63321,13828,16.3045,64.3678
OKLAHOMA,5,REPUBLICAN,145658,158191,303849,151924,145658,6266,45.8754,85.0575,7282,696,2.1675,11.4943
OREGON,1,DEMOCRAT,297071,161928,458999,229499,67571,161928,20.5571,37.2414,12323,80964,14.9545,55.1724
OREGON,2,REPUBLICAN,168881,273835,442716,221357,168881,52476,26.2934,48.5057,84440,7653,17.3445,68.5057
OREGON,3,DEMOCRAT,343574,110570,454144,227071,116501,110570,1.306,2.2989,33514,60813,6.0111,25.977
OREGON,4,DEMOCRAT,240950,216081,457031,228515,12434,216081,44.5587,82.9885,1381,10804,2.0618,8.7356
OREGON,5,DEMOCRAT,234863,204372,439235,219617,15245,204372,43.0583,79.3103,1693,10218,1.9409,5.0575
PENNSYLVANIA,1,REPUBLICAN,191875,249804,441679,220839,191875,28964,36.8845,70.3448,38375,2755,8.0647,39.7701
PENNSYLVANIA,2,DEMOCRAT,198140,75022,273162,136580,61558,75022,4.9289,9.4253,15988,52515,13.3719,51.0345
PENNSYLVANIA,3,DEMOCRAT,341708,33671,375379,187689,154018,33671,32.0601,60.6897,70599,5050,17.4621,69.1954
PENNSYLVANIA,4,DEMOCRAT,264637,179926,444563,222281,42355,179926,30.9452,59.0805,5707,35985,6.8107,28.046
PENNSYLVANIA,5,DEMOCRAT,255743,139552,395295,197647,58095,139552,20.6066,37.931,10580,69776,14.9751,55.8621
PENNSYLVANIA,6,DEMOCRAT,226440,177526,403966,201982,24456,177526,37.8918,72.4138,2068,35505,8.2772,41.8391
PENNSYLVANIA,7,DEMOCRAT,195475,181407,376882,188440,7033,181407,46.2675,85.7471,781,9070,2.1994,12.1839
PENNSYLVANIA,8,DEMOCRAT,178004,165783,343787,171893,6110,165783,46.4453,86.4368,678,8289,2.2139,12.8736
PENNSYLVANIA,9,REPUBLICAN,118266,232988,351254,175626,118266,57360,17.3396,32.4138,100526,10857,25.5283,89.6552
PENNSYLVANIA,10,REPUBLICAN,182938,208896,391834,195916,182938,12978,43.3755,80.0,9146,1441,1.9664,5.7471
PENNSYLVANIA,11,REPUBLICAN,141325,241915,383240,191619,141325,50294,23.753,44.5977,70662,8248,16.2859,64.1379
PENNSYLVANIA,12,REPUBLICAN,99199,241035,340234,170116,99199,70917,8.3125,16.3218,69439,16716,15.4961,60.0
PENNSYLVANIA,13,REPUBLICAN,96612,267789,364401,182200,96612,85588,3.0252,5.0575,67628,23255,12.177,48.5057
PENNSYLVANIA,14,REPUBLICAN,131895,241688,373583,186791,131895,54896,20.6109,38.1609,65947,9996,14.9769,56.092
PENNSYLVANIA,15,REPUBLICAN,92156,255058,347214,173606,92156,81450,3.0834,5.2874,64509,22102,12.2135,48.7356
PENNSYLVANIA,16,REPUBLICAN,143962,210088,354050,177024,143962,33062,31.3233,60.0,28792,4396,6.8906,29.1954
PENNSYLVANIA,17,DEMOCRAT,222253,212284,434537,217268,4984,212284,47.7059,89.6552,553,10614,2.3153,16.3218
PENNSYLVANIA,18,DEMOCRAT,266084,118163,384247,192123,73960,118163,11.5038,21.3793,16860,100438,21.7511,80.4598
RHODE ISLAND,1,DEMOCRAT,158550,0,158550,79274,79274,0,49.9994,94.2529,44480,0,28.0542,94.023
RHODE ISLAND,2,DEMOCRAT,154086,109894,263980,131989,22095,109894,33.2597,63.6782,2710,21978,7.299,33.1034
SOUTH CAROLINA,1,REPUBLICAN,210627,216042,426669,213334,210627,2707,48.731,91.2644,10531,300,2.3979,18.1609
SOUTH CAROLINA,2,REPUBLICAN,155118,202715,357833,178916,155118,23798,36.6987,69.4253,31023,2306,8.0253,38.8506
SOUTH CAROLINA,3,REPUBLICAN,95712,237544,333256,166627,95712,70915,7.4408,14.023,66998,17180,14.9489,54.9425
SOUTH CAROLINA,4,REPUBLICAN,133023,222126,355149,177574,133023,44551,24.9112,46.2069,66511,6957,16.7687,66.2069
SOUTH CAROLINA,5,REPUBLICAN,145979,220006,365985,182992,145979,37013,29.7734,56.7816,72989,4204,18.7945,77.0115
SOUTH CAROLINA,6,DEMOCRAT,197477,89258,286735,143367,54109,89258,12.2584,22.9885,12100,75869,22.2397,81.8391
SOUTH CAROLINA,7,REPUBLICAN,138863,224993,363856,181927,138863,43064,26.3288,48.7356,69431,6268,17.3593,68.7356
SOUTH DAKOTA,0,REPUBLICAN,0,321984,321984,160991,0,160991,49.9997,97.7011,0,90333,28.0551,99.3103
TENNESSEE,1,REPUBLICAN,68617,228181,296798,148398,68617,79781,3.7615,6.8966,37739,24331,4.5176,22.9885
TENNESSEE,2,REPUBLICAN,109684,238907,348591,174295,109684,64611,12.9301,25.2874,93231,14191,22.6741,83.4483
TENNESSEE,3,REPUBLICAN,97687,215571,313258,156628,97687,58941,12.3687,23.6782,83033,13143,22.3107,82.2989
TENNESSEE,4,REPUBLICAN,111908,223802,335710,167854,111908,55946,16.6697,31.7241,95121,10876,25.0946,88.9655
TENNESSEE,5,DEMOCRAT,252155,0,252155,126077,126077,0,49.9998,99.3103,70742,0,28.055,98.3908
TENNESSEE,6,REPUBLICAN,83852,257572,341424,170711,83852,86859,0.8807,1.3793,46118,24712,6.2696,26.2069
TENNESSEE,7,REPUBLICAN,95839,245188,341027,170513,95839,74674,6.2063,10.8046,67087,18750,14.174,52.4138
TENNESSEE,8,REPUBLICAN,97890,227216,325106,162552,97890,64662,10.2207,18.6207,83206,15192,20.9206,78.1609
TENNESSEE,9,DEMOCRAT,187905,48818,236723,118361,69543,48818,8.755,16.7816,23346,26849,1.4798,0.2299
TEXAS,1,REPUBLICAN,83016,219726,302742,151370,83016,68354,4.8431,9.1954,58111,17791,13.3183,50.8046
TEXAS,2,REPUBLICAN,148374,192828,341202,170600,148374,22226,36.9716,70.5747,29674,2095,8.0829,40.0
TEXAS,3,REPUBLICAN,179458,230512,409970,204984,179458,25526,37.5471,71.7241,35891,2256,8.2043,41.1494
TEXAS,4,REPUBLICAN,76326,253837,330163,165081,76326,88755,3.7645,7.1264,41979,27070,4.5156,22.7586
TEXAS,5,REPUBLICAN,100743,173836,274579,137289,100743,36546,23.3802,43.2184,50371,6080,16.1305,62.5287
TEXAS,6,REPUBLICAN,149530,179507,329037,164518,149530,14988,40.8896,76.3218,7476,1665,1.7661,1.8391
TEXAS,7,DEMOCRAT,159529,149054,308583,154291,5237,149054,46.6056,86.8966,581,7452,2.2266,13.3333
TEXAS,8,REPUBLICAN,97409,277327,374736,187367,97409,89958,1.9883,3.908,68186,24994,11.526,47.5862
TEXAS,9,DEMOCRAT,172938,49575,222513,111256,61681,49575,5.4406,9.6552,19487,27266,3.496,21.6092
TEXAS,10,REPUBLICAN,187686,217216,404902,202450,187686,14764,42.7071,78.8506,9384,1640,1.9126,4.5977
TEXAS,11,REPUBLICAN,53394,232568,285962,142980,53394,89586,12.6562,24.5977,21357,31549,3.5641,21.8391
TEXAS,12,REPUBLICAN,121250,233853,355103,177551,121250,56301,18.2902,34.2529,103062,10226,26.1434,91.2644
TEXAS,13,REPUBLICAN,50477,217124,267601,133800,50477,83323,12.2742,23.2184,20190,29126,3.3393,21.1494
TEXAS,14,REPUBLICAN,118574,190541,309115,154557,118574,35983,26.7185,49.6552,59287,5124,17.522,69.8851
TEXAS,15,DEMOCRAT,115605,109017,224622,112310,3293,109017,47.0675,87.8161,365,5450,2.2638,14.4828
TEXAS,16,DEMOCRAT,154108,84006,238114,119056,35050,84006,20.5599,37.4713,6391,42003,14.9559,55.4023
TEXAS,17,REPUBLICAN,125565,171390,296955,148477,125565,22912,34.5685,66.4368,25113,2616,7.5759,35.8621
TEXAS,18,DEMOCRAT,180952,58033,238985,119492,61459,58033,1.4336,2.5287,17737,31918,5.9338,25.7471
TEXAS,19,REPUBLICAN,60583,198198,258781,129390,60583,68807,3.178,5.7471,33320,20711,4.8725,24.1379
TEXAS,20,DEMOCRAT,175078,89628,264706,132352,42724,89628,17.7193,33.1034,7959,76183,25.7735,90.3448
TEXAS,21,REPUBLICAN,205780,235740,441520,220759,205780,14979,43.2146,79.7701,10289,1664,1.9535,5.5172
TEXAS,22,REPUBLICAN,181998,210259,392257,196128,181998,14130,42.7954,79.0805,9099,1569,1.9197,4.8276
TEXAS,23,REPUBLICAN,137693,149395,287088,143543,137693,5850,45.9242,85.2874,6884,650,2.1715,11.7241
TEXAS,24,REPUBLICAN,163326,167910,331236,165617,163326,2291,48.6164,90.8046,8166,254,2.3886,17.7011
TEXAS,25,REPUBLICAN,165697,220088,385785,192892,165697,27195,35.9013,68.5057,33139,2828,7.857,37.931
TEXAS,26,REPUBLICAN,161009,261963,422972,211485,161009,50476,26.1325,48.2759,80504,7425,17.2775,68.2759
TEXAS,27,REPUBLICAN,95466,172305,267771,133885,95466,38419,21.3044,40.0,47733,6855,15.266,58.3908
TEXAS,28,DEMOCRAT,137494,91925,229419,114709,22784,91925,30.1374,57.931,3151,18385,6.6403,26.6667
TEXAS,29,DEMOCRAT,111305,42840,154145,77072,34232,42840,5.5844,9.8851,8741,29987,13.7831,51.2644
TEXAS,30,DEMOCRAT,204928,48685,253613,126806,78121,48685,11.6067,21.6092,26945,19474,2.9458,20.9195
TEXAS,31,REPUBLICAN,176293,212695,388988,194493,176293,18200,40.6421,75.4023,8814,2022,1.7461,0.9195
TEXAS,32,DEMOCRAT,178542,157867,336409,168204,10337,157867,43.8544,81.3793,1148,7893,2.005,7.1264
TEXAS,33,DEMOCRAT,105317,39638,144955,72477,32839,39638,4.6904,8.7356,8579,27746,13.2227,50.5747
TEXAS,34,DEMOCRAT,111439,84119,195558,97778,13659,84119,36.0302,68.9655,1405,16823,7.8841,38.3908
TEXAS,35,DEMOCRAT,176373,80795,257168,128583,47788,80795,12.8348,24.8276,10523,68675,22.6125,82.9885
TEXAS,36,REPUBLICAN,73418,222712,296130,148064,73418,74646,0.4147,0.6897,40379,20973,6.5532,26.4368
UTAH,1,REPUBLICAN,104194,237988,342182,171090,104194,66896,10.9,20.0,88564,15473,21.3603,79.5402
UTAH,2,REPUBLICAN,129762,208997,338759,169379,129762,39617,26.6104,49.4253,64881,5677,17.4767,69.6552
UTAH,3,REPUBLICAN,96067,246674,342741,171370,96067,75303,6.0582,10.5747,67246,18985,14.0809,52.1839
UTAH,4,REPUBLICAN,175923,179688,355611,177805,175923,1882,48.9414,91.954,8796,209,2.4147,18.8506
VERMONT,0,DEMOCRAT,238827,95830,334657,167328,71498,95830,7.2707,12.8736,17410,67081,14.8424,54.023
VIRGINIA,1,REPUBLICAN,186923,260614,447537,223768,186923,36845,33.5342,65.0575,37384,4458,7.3572,34.4828
VIRGINIA,2,DEMOCRAT,185733,165031,350764,175381,10350,165031,44.0983,82.2989,1150,8251,2.0244,8.046
VIRGINIA,3,DEMOCRAT,233326,107299,340625,170312,63013,107299,13.0014,25.7471,13812,91204,22.7206,83.908
VIRGINIA,4,DEMOCRAT,241142,149625,390767,195383,45758,149625,26.5803,49.1954,6568,74812,17.4641,69.4253
VIRGINIA,5,REPUBLICAN,190315,210988,401303,200651,190315,10336,44.8487,83.6782,9515,1148,2.085,9.6552
VIRGINIA,6,REPUBLICAN,134729,246606,381335,190667,134729,55938,20.6619,38.3908,67364,10171,14.9981,56.3218
VIRGINIA,7,DEMOCRAT,230893,222623,453516,226757,4134,222623,48.1767,90.1149,459,11131,2.3532,17.0115
VIRGINIA,8,DEMOCRAT,301454,95365,396819,198409,103044,95365,1.9351,3.6782,30116,52450,5.6283,24.8276
VIRGINIA,9,REPUBLICAN,0,271851,271851,135925,0,135925,49.9998,99.5402,0,76268,28.0551,99.5402
VIRGINIA,10,DEMOCRAT,268734,206253,474987,237493,31240,206253,36.8459,70.1149,2983,41250,8.0564,39.5402
VIRGINIA,11,DEMOCRAT,280725,111380,392105,196052,84672,111380,6.8114,12.1839,20899,77966,14.554,53.5632
WASHINGTON,1,DEMOCRAT,249944,176407,426351,213175,36768,176407,32.7521,62.7586,4617,35281,7.1922,32.1839
WASHINGTON,2,DEMOCRAT,255252,148384,403636,201817,53433,148384,23.5239,43.908,8841,74192,16.1906,63.2184
WASHINGTON,3,REPUBLICAN,181347,235579,416926,208462,181347,27115,36.9927,70.8046,36269,2551,8.0873,40.2299
WASHINGTON,4,REPUBLICAN,102667,202108,304775,152387,102667,49720,17.3725,32.6437,87266,9398,25.5493,89.8851
WASHINGTON,5,REPUBLICAN,155737,247815,403552,201775,155737,46038,27.1834,50.8046,77868,6378,17.7152,71.2644
WASHINGTON,6,DEMOCRAT,247429,168783,416212,208105,39322,168783,31.1046,59.3103,5269,33756,6.8443,28.5057
WASHINGTON,7,DEMOCRAT,387109,78240,465349,232674,154434,78240,16.3735,31.0345,58068,31296,5.7531,25.0575
WASHINGTON,8,DEMOCRAT,213123,198423,411546,205772,7349,198423,46.4283,86.2069,816,9921,2.2124,12.6437
WASHINGTON,9,DEMOCRAT,258771,89697,348468,174233,84536,89697,1.4811,2.9885,23733,62787,11.2073,47.1264
WASHINGTON,10,DEMOCRAT,167937,0,167937,83968,83968,0,49.9997,97.931,47114,0,28.0546,95.6322
WEST VIRGINIA,1,REPUBLICAN,81177,180488,261665,130832,81177,49655,12.0467,22.2989,69000,11165,22.1027,81.1494
WEST VIRGINIA,2,REPUBLICAN,100799,172195,272994,136496,100799,35697,23.8474,45.0575,50399,5832,16.3253,64.8276
WEST VIRGINIA,3,REPUBLICAN,64927,161585,226512,113255,64927,48328,7.3281,13.3333,45448,11748,14.8778,54.4828
WISCONSIN,1,REPUBLICAN,163170,238271,401441,200720,163170,37550,31.2923,59.7701,32634,4998,6.8842,28.9655
WISCONSIN,2,DEMOCRAT,318523,138306,456829,228414,90108,138306,10.5506,19.7701,21013,117560,21.1342,79.3103
WISCONSIN,3,DEMOCRAT,199870,189524,389394,194696,5172,189524,47.3433,88.7356,574,9476,2.2861,15.4023
WISCONSIN,4,DEMOCRAT,232668,70769,303437,151718,80949,70769,3.3549,6.2069,24464,38922,4.7647,23.908
WISCONSIN,5,REPUBLICAN,175902,265434,441336,220667,175902,44765,29.7136,56.5517,87951,5114,18.7696,76.7816
WISCONSIN,6,REPUBLICAN,164239,238874,403113,201556,164239,37317,31.4855,60.2299,32847,4933,6.9246,29.4253
WISCONSIN,7,REPUBLICAN,162741,252048,414789,207394,162741,44653,28.4694,54.023,81370,5666,18.2512,74.2529
WISCONSIN,8,REPUBLICAN,149558,268173,417731,208865,149558,59307,21.6051,40.6897,74779,10485,15.3912,58.8506
WYOMING,0,REPUBLICAN,66576,185732,252308,126153,66576,59577,2.774,4.5977,46603,16277,12.0194,48.046
